5A8	Aleknagik / New Airport
AGGH	Honiara International Airport
AGGM	Munda Airport
AHJ	Hongyuan Airport
ANYN	Nauru International Airport
AU-0121	YKCY
AXF	Alxa Left Banner Bayanhot Airport
AYBK	Buka Airport
AYCH	Chimbu Airport
AYDU	Daru Airport
AYGA	Goroka Airport
AYGN	Gurney Airport
AYGR	Girua Airport
AYHK	Kimbe Airport
AYKM	Kerema Airport
AYKV	Kavieng Airport
AYMD	Madang Airport
AYMH	Mount Hagen Kagamuga Airport
AYMN	Mendi Airport
AYMO	Momote Airport
AYNZ	Nadzab Airport
AYPY	Port Moresby Jacksons International Airport
AYTK	Tokua Airport
AYVN	Vanimo Airport
AYWD	Wapenamanda Airport
AYWK	Wewak International Airport
AZ-0001	Zabrat Airport
AZ-0013	Sital Chay Airport
AZ-0021	Kyzylagadzh Air Base
BCW	Benguera Island Airport
BG-JAM	Bezmer Air Base
BGAA	Aasiaat Airport
BGBW	Narsarsuaq Airport
BGGH	Godthaab / Nuuk Airport
BGSF	Kangerlussuaq Airport
BGTL	Thule Air Base
BIAR	Akureyri Airport
BIEG	EgilsstaÃ°ir Airport
BIHN	HornafjÃ¶rÃ°ur Airport
BIHU	HÃºsavÃ­k Airport
BIIS	ÃsafjÃ¶rÃ°ur Airport
BIKF	Keflavik International Airport
BIRK	Reykjavik Airport
BISI	SiglufjÃ¶rÃ°ur Airport
BIVM	Vestmannaeyjar Airport
BKPR	PriÅ¡tina International Airport
BY-0001	Balbasovo Air Base
BY-0003	Bobrovichi Air Base
BY-0006	Osovtsy Air Base
BZ-BGK	Big Creek Airport
BZ-CUK	Caye Caulker Airport
BZ-CYC	Caye Chapel Airport
BZ-CZH	Corozal Municipal Airport
BZ-DGA	Dangriga Airport
BZ-PLJ	Placencia Airport
BZ-PND	Punta Gorda Airport
BZ-SJX	Sartaneja Airport
BZ-SPR	San Pedro Airport
BZ-TZA	Belize City Municipal Airport
BZB	Bazaruto Island Airport
CA-0671	Cyll
CA-0673	Cycd
CN-0002	Nanjing Air Base
CN-0003	Laohutun Air Base
CN-0004	Pulandian Air Base
CN-0006	Beijing Shahezhen Air Base
CN-0007	Beijing Tongxian Air Base
CN-0010	Yinchuan Hedong International Airport
CN-0012	Yuanmou Air Base
CN-0013	Fengning Air Base
CN-0014	Hohhot Air Base
CN-0015	Huairen Air Base
CN-0016	Liangxiangzhen Air Base
CN-0018	Tangguantun Air Base
CN-0020	Wenshui Air Base
CN-0021	Yangcun Air Base
CN-0022	Yongning Air Base
CN-0024	Zhangjiakou Ningyuan Airport
CN-0025	Zunhua Air Base
CN-0026	Chengdu Air Base
CN-0027	Baoshan Yunduan Airport
CN-0030	Chongqing Air Base
CN-0040	Lintsang Airfield
CN-0041	Luliang Air Base
CN-0043	Mengzi Air Base
CN-0045	Qionglai Air Base
CN-0046	Shigatse Air Base
CN-0048	Wenshan Air Base
CN-0049	Xiangyun Midu Air Base
CN-0050	Bao'anying Airport
CN-0053	Baihe Ning Ming Air Base
CN-0055	Changsha Datuopu Airport/AFB
CN-0056	Dangyang Air Base
CN-0057	Foluo Northeast Air Base
CN-0061	Foshan Shadi Airport
CN-0063	Guiping Mengshu Air Base
CN-0068	Huizhou Airport
CN-0069	Jialaishi Air Base
CN-0071	Leiyang Air Base
CN-0072	Lingshui Air Base
CN-0074	Shangqiu Air Base
CN-0076	Zhengzhou Air Base
CN-0079	Shaoguan Guitou Airport
CN-0080	Suixi Air Base
CN-0081	Jinggangshan Airport
CN-0082	Baise Youjiang Airport
CN-0083	Guodu air base
CN-0085	Xiaogan Air Base
CN-0089	Baitabu Air Base
CN-0090	Cangxian Air Base
CN-0091	Dongying Shengli Airport
CN-0092	Jiaozhou/Jiaocheng Air Base
CN-0093	Jinan Air Base
CN-0094	Jiugucheng Air Base
CN-0095	Kaifeng Air Base
CN-0096	Laiyang Air Base
CN-0097	Luyang Air Base
CN-0100	Qingdao-Cangkou Air Base
CN-0103	Wendeng Air Base
CN-0104	Xingcheng Air Base
CN-0105	Xuzhou Daguozhang Air Base
CN-0106	Xuzhou Jiulishan Air Base
CN-0109	Yidu Air Base
CN-0111	Zhucheng Air Base
CN-0113	Altay Air Base
CN-0114	Baoji Air Base
CN-0117	Gonghe Air Base
CN-0123	Lanzhou Air Base
CN-0125	Ljtao Air Base
CN-0127	Qingshui Air Base
CN-0130	Tianshui Maijishan Airport
CN-0132	Urumqi South Air Base
CN-0133	Uxxaktal Air Base
CN-0134	Wugong Air Base
CN-0135	Wulumuqi Air Base
CN-0136	Wuwei Air Base
CN-0137	Xian Air Base
CN-0138	Xincheng Air Base
CN-0139	Yaerbashi Test Range
CN-0140	Yanliang Air Base
CN-0143	Zhangye Ganzhou Airport
CN-0145	Changzing Air Base
CN-0146	Daishan Air Base
CN-0147	Feidong Air Base
CN-0149	Fuzhou Air Base
CN-0152	Huian Air Base
CN-0153	Jianqiao/Hangzhou Airfield
CN-0154	Jiaxing Air Base
CN-0158	Longtian/Lung-T'ien Air Base
CN-0159	Longyou Air Base
CN-0161	Mahuiling Air Base
CN-0162	Nanchang New Airfield
CN-0163	Nanchang Xiangtang Air Base
CN-0165	Ningbo Zhangqiao Air Base
CN-0169	Shanghai Dachang Air Base
CN-0182	Zhangshu Air Base
CN-0185	Changchun Air Base
CN-0187	Chifeng Air Base
CN-0189	Dandong Airport
CN-0190	Dingxin/Shuangchengzi Air Base
CN-0191	Fuxin Air Base
CN-0192	Gongzhuling Air Base
CN-0193	Harbin Air Base
CN-0197	Kaiyuan Air Base
CN-0198	Lalin Air Base
CN-0201	Pingquan Air Base
CN-0204	Shenyang Beiling Air Base
CN-0206	Shenyang Yu Hung Tun Air Base
CN-0208	Siping Air Base
CN-0209	Suizhong Air Base
CN-0210	Tuchengzi Air Base
CN-JNZ	Sanshilipu Air Base
CNC3	Brampton Airport
CY-0002	Lefkoniko Airport
CYAC	Cat Lake Airport
CYAG	Fort Frances Municipal Airport
CYAH	La Grande-4 Airport
CYAL	Alert Bay Airport
CYAM	Sault Ste Marie Airport
CYAQ	Kasabonika Airport
CYAS	Kangirsuk Airport
CYAT	Attawapiskat Airport
CYAU	Liverpool South Shore Regional Airport
CYAV	Winnipeg / St. Andrews Airport
CYAX	Lac Du Bonnet Airport
CYAY	St. Anthony Airport
CYAZ	Tofino / Long Beach Airport
CYBB	Kugaaruk Airport
CYBC	Baie Comeau Airport
CYBD	Bella Coola Airport
CYBE	Uranium City Airport
CYBF	Bonnyville Airport
CYBG	CFB Bagotville
CYBK	Baker Lake Airport
CYBL	Campbell River Airport
CYBQ	Tadoule Lake Airport
CYBR	Brandon Municipal Airport
CYBT	Brochet Airport
CYBU	Nipawin Airport
CYBV	Berens River Airport
CYBW	Calgary / Springbank Airport
CYBX	Lourdes de Blanc Sablon Airport
CYCA	Cartwright Airport
CYCB	Cambridge Bay Airport
CYCC	Cornwall Regional Airport
CYCD	Nanaimo Airport
CYCE	Centralia / James T. Field Memorial Aerodrome
CYCG	Castlegar/West Kootenay Regional Airport
CYCH	Miramichi Airport
CYCL	Charlo Airport
CYCN	Cochrane Airport
CYCO	Kugluktuk Airport
CYCP	Blue River Airport
CYCQ	Chetwynd Airport
CYCR	Cross Lake (Charlie Sinclair Memorial) Airport
CYCS	Chesterfield Inlet Airport
CYCY	Clyde River Airport
CYDA	Dawson City Airport
CYDB	Burwash Airport
CYDC	Princeton Airport
CYDF	Deer Lake Airport
CYDM	Ross River Airport
CYDN	Dauphin Barker Airport
CYDO	Dolbeau St Felicien Airport
CYDP	Nain Airport
CYDQ	Dawson Creek Airport
CYEE	Huronia Airport
CYEG	Edmonton International Airport
CYEK	Arviat Airport
CYEL	Elliot Lake Municipal Airport
CYEM	Manitoulin East Municipal Airport
CYEN	Estevan Airport
CYER	Fort Severn Airport
CYET	Edson Airport
CYEV	Inuvik Mike Zubko Airport
CYEY	Amos/Magny Airport
CYFA	Fort Albany Airport
CYFB	Iqaluit Airport
CYFC	Fredericton Airport
CYFE	Forestville Airport
CYFH	Fort Hope Airport
CYFJ	La Macaza / Mont-Tremblant International Inc Airport
CYFO	Flin Flon Airport
CYFR	Fort Resolution Airport
CYFS	Fort Simpson Airport
CYFT	Makkovik Airport
CYGB	Texada Gillies Bay Airport
CYGD	Goderich Airport
CYGE	Golden Airport
CYGH	Fort Good Hope Airport
CYGK	Kingston Norman Rogers Airport
CYGL	La Grande RiviÃ¨re Airport
CYGM	Gimli Industrial Park Airport
CYGO	Gods Lake Narrows Airport
CYGP	GaspÃ© (Michel-Pouliot) Airport
CYGQ	Geraldton Greenstone Regional Airport
CYGR	ÃŽles-de-la-Madeleine Airport
CYGT	Igloolik Airport
CYGV	Havre St Pierre Airport
CYGW	Kuujjuarapik Airport
CYGX	Gillam Airport
CYGZ	Grise Fiord Airport
CYHA	Quaqtaq Airport
CYHD	Dryden Regional Airport
CYHE	Hope Airport
CYHF	Hearst RenÃ© Fontaine Municipal Airport
CYHH	Nemiscau Airport
CYHI	Ulukhaktok Holman Airport
CYHK	Gjoa Haven Airport
CYHM	John C. Munro Hamilton International Airport
CYHN	Hornepayne Municipal Airport
CYHO	Hopedale Airport
CYHR	Chevery Airport
CYHT	Haines Junction Airport
CYHU	MontrÃ©al / Saint-Hubert Airport
CYHY	Hay River / Merlyn Carter Airport
CYHZ	Halifax / Stanfield International Airport
CYIB	Atikokan Municipal Airport
CYID	Digby / Annapolis Regional Airport
CYIF	St Augustin Airport
CYIK	Ivujivik Airport
CYIO	Pond Inlet Airport
CYIV	Island Lake Airport
CYJF	Fort Liard Airport
CYJN	St Jean Airport
CYJT	Stephenville Airport
CYKA	Kamloops Airport
CYKD	Aklavik/Freddie Carmichael Airport
CYKF	Waterloo Airport
CYKG	Kangiqsujuaq (Wakeham Bay) Airport
CYKJ	Key Lake Airport
CYKL	Schefferville Airport
CYKO	Akulivik Airport
CYKQ	Waskaganish Airport
CYKX	Kirkland Lake Airport
CYKY	Kindersley Airport
CYKZ	Buttonville Municipal Airport
CYLA	Aupaluk Airport
CYLC	Kimmirut Airport
CYLD	Chapleau Airport
CYLH	Lansdowne House Airport
CYLJ	Meadow Lake Airport
CYLK	Lutselk'e Airport
CYLL	Lloydminster Airport
CYLR	Leaf Rapids Airport
CYLT	Alert Airport
CYLU	Kangiqsualujjuaq (Georges River) Airport
CYLW	Kelowna International Airport
CYMA	Mayo Airport
CYME	Matane Airport
CYMG	Manitouwadge Airport
CYMH	Mary's Harbour Airport
CYMJ	Moose Jaw Air Vice Marshal C. M. McEwen Airport
CYML	Charlevoix Airport
CYMM	Fort McMurray Airport
CYMO	Moosonee Airport
CYMT	Chapais Airport
CYMU	Umiujaq Airport
CYMX	Montreal International (Mirabel) Airport
CYNA	Natashquan Airport
CYNC	Wemindji Airport
CYND	Ottawa / Gatineau Airport
CYNE	Norway House Airport
CYNL	Points North Landing Airport
CYNM	Matagami Airport
CYNN	Nejanilini Lake Airport
CYOA	Ekati Airport
CYOC	Old Crow Airport
CYOD	CFB Cold Lake
CYOH	Oxford House Airport
CYOJ	High Level Airport
CYOO	Toronto/Oshawa Executive Airport
CYOP	Rainbow Lake Airport
CYOS	Owen Sound / Billy Bishop Regional Airport
CYOW	Ottawa Macdonald-Cartier International Airport
CYPA	Prince Albert Glass Field
CYPC	Paulatuk (Nora Aliqatchialuk Ruben) Airport
CYPD	Port Hawkesbury Airport
CYPE	Peace River Airport
CYPG	Southport Airport
CYPH	Inukjuak Airport
CYPL	Pickle Lake Airport
CYPM	Pikangikum Airport
CYPN	Port Menier Airport
CYPO	Peawanuck Airport
CYPQ	Peterborough Airport
CYPR	Prince Rupert Airport
CYPW	Powell River Airport
CYPX	Puvirnituq Airport
CYPY	Fort Chipewyan Airport
CYQA	Muskoka Airport
CYQB	Quebec Jean Lesage International Airport
CYQD	The Pas Airport
CYQF	Red Deer Regional Airport
CYQG	Windsor Airport
CYQH	Watson Lake Airport
CYQI	Yarmouth Airport
CYQK	Kenora Airport
CYQL	Lethbridge County Airport
CYQM	Greater Moncton International Airport
CYQN	Nakina Airport
CYQQ	Comox Airport
CYQR	Regina International Airport
CYQS	St Thomas Municipal Airport
CYQT	Thunder Bay Airport
CYQU	Grande Prairie Airport
CYQV	Yorkton Municipal Airport
CYQW	North Battleford Airport
CYQX	Gander International Airport
CYQY	Sydney / J.A. Douglas McCurdy Airport
CYQZ	Quesnel Airport
CYRA	Rae Lakes Airport
CYRB	Resolute Bay Airport
CYRI	RiviÃ¨re-du-Loup Airport
CYRJ	Roberval Airport
CYRL	Red Lake Airport
CYRO	Ottawa / Rockcliffe Airport
CYRP	Ottawa / Carp Airport
CYRQ	Trois-RiviÃ¨res Airport
CYRS	Red Sucker Lake Airport
CYRT	Rankin Inlet Airport
CYRV	Revelstoke Airport
CYSB	Sudbury Airport
CYSC	Sherbrooke Airport
CYSF	Stony Rapids Airport
CYSG	St Georges Airport
CYSH	Smiths Falls-Montague (Russ Beach) Airport
CYSJ	Saint John Airport
CYSK	Sanikiluaq Airport
CYSL	St Leonard Airport
CYSM	Fort Smith Airport
CYSN	Niagara District Airport
CYSP	Marathon Airport
CYST	St. Theresa Point Airport
CYSU	Summerside Airport
CYSY	Sachs Harbour (David Nasogaluak Jr. Saaryuaq) Airport
CYTA	Pembroke Airport
CYTE	Cape Dorset Airport
CYTF	Alma Airport
CYTH	Thompson Airport
CYTL	Big Trout Lake Airport
CYTQ	Tasiujaq Airport
CYTR	CFB Trenton
CYTS	Timmins/Victor M. Power
CYTZ	Billy Bishop Toronto City Centre Airport
CYUB	Tuktoyaktuk Airport
CYUL	Montreal / Pierre Elliott Trudeau International Airport
CYUT	Repulse Bay Airport
CYUX	Hall Beach Airport
CYUY	Rouyn Noranda Airport
CYVB	Bonaventure Airport
CYVC	La Ronge Airport
CYVD	Virden/R.J. (Bob) Andrew Field Regional Aerodrome
CYVK	Vernon Airport
CYVM	Qikiqtarjuaq Airport
CYVO	Val-d'Or Airport
CYVP	Kuujjuaq Airport
CYVQ	Norman Wells Airport
CYVR	Vancouver International Airport
CYVV	Wiarton Airport
CYVZ	Deer Lake Airport
CYWA	Petawawa Airport
CYWG	Winnipeg / James Armstrong Richardson International Airport
CYWJ	DÃ©line Airport
CYWK	Wabush Airport
CYWL	Williams Lake Airport
CYWP	Webequie Airport
CYWY	Wrigley Airport
CYXC	Cranbrook/Canadian Rockies International Airport
CYXE	Saskatoon John G. Diefenbaker International Airport
CYXH	Medicine Hat Airport
CYXJ	Fort St John Airport
CYXK	Rimouski Airport
CYXL	Sioux Lookout Airport
CYXN	Whale Cove Airport
CYXP	Pangnirtung Airport
CYXQ	Beaver Creek Airport
CYXR	Earlton (Timiskaming Regional) Airport
CYXS	Prince George Airport
CYXT	Northwest Regional Airport Terrace-Kitimat
CYXU	London Airport
CYXX	Abbotsford Airport
CYXY	Whitehorse / Erik Nielsen International Airport
CYXZ	Wawa Airport
CYYB	North Bay Jack Garland Airport
CYYC	Calgary International Airport
CYYD	Smithers Airport
CYYE	Fort Nelson Airport
CYYF	Penticton Airport
CYYG	Charlottetown Airport
CYYH	Taloyoak Airport
CYYJ	Victoria International Airport
CYYL	Lynn Lake Airport
CYYN	Swift Current Airport
CYYQ	Churchill Airport
CYYR	Goose Bay Airport
CYYT	St. John's International Airport
CYYU	Kapuskasing Airport
CYYW	Armstrong Airport
CYYY	Mont Joli Airport
CYYZ	Lester B. Pearson International Airport
CYZD	Downsview Airport
CYZE	Gore Bay Manitoulin Airport
CYZF	Yellowknife Airport
CYZG	Salluit Airport
CYZH	Slave Lake Airport
CYZP	Sandspit Airport
CYZR	Chris Hadfield Airport
CYZS	Coral Harbour Airport
CYZT	Port Hardy Airport
CYZU	Whitecourt Airport
CYZV	Sept-ÃŽles Airport
CYZW	Teslin Airport
CYZX	CFB Greenwood
CYZY	Mackenzie Airport
CZAC	York Landing Airport
CZAM	Shuswap Regional Airport
CZBB	Boundary Bay Airport
CZBD	Ilford Airport
CZBF	Bathurst Airport
CZBM	Bromont (Roland Desourdy) Airport
CZEE	Kelsey Airport
CZEM	Eastmain River Airport
CZFA	Faro Airport
CZFD	Fond-Du-Lac Airport
CZFG	Pukatawagan Airport
CZFM	Fort Mcpherson Airport
CZFN	Tulita Airport
CZGF	Grand Forks Airport
CZGI	Gods River Airport
CZGR	Little Grand Rapids Airport
CZJG	Jenpeg Airport
CZJN	Swan River Airport
CZKE	Kashechewan Airport
CZLQ	Thicket Portage Airport
CZMD	Muskrat Dam Airport
CZMN	Pikwitonei Airport
CZMT	Masset Airport
CZNG	Poplar River Airport
CZPB	Sachigo Lake Airport
CZPC	Pincher Creek Airport
CZRJ	Round Lake (Weagamow Lake) Airport
CZSJ	Sandy Lake Airport
CZSN	South Indian Lake Airport
CZST	Stewart Airport
CZTM	Shamattawa Airport
CZUC	Ignace Municipal Airport
CZWH	Lac Brochet Airport
CZWL	Wollaston Lake Airport
DAAB	Blida Airport
DAAD	Bou Saada Airport
DAAE	Soummam Airport
DAAG	Houari Boumediene Airport
DAAJ	Djanet Inedbirene Airport
DAAK	Boufarik Airport
DAAP	Illizi Takhamalt Airport
DAAS	Ain Arnat Airport
DAAT	Aguenar â€“ Hadj Bey Akhamok Airport
DAAV	Jijel Ferhat Abbas Airport
DAAY	Mecheria Airport
DAAZ	Relizane Airport
DABB	Rabah Bitat Airport
DABC	Mohamed Boudiaf International Airport
DABS	Cheikh Larbi TÃ©bessi Airport
DABT	Batna Airport
DAFH	Hassi R'Mel Airport
DAOB	Bou Chekif Airport
DAOF	Tindouf Airport
DAOI	Ech Cheliff Airport
DAOL	Tafaraoui Airport
DAON	Zenata â€“ Messali El Hadj Airport
DAOO	Es Senia Airport
DAOR	BÃ©char Boudghene Ben Ali Lotfi Airport
DAOV	Ghriss Airport
DAUA	Touat Cheikh Sidi Mohamed Belkebir Airport
DAUB	Biskra Airport
DAUE	El Golea Airport
DAUG	NoumÃ©rat - Moufdi Zakaria Airport
DAUH	Oued Irara Airport
DAUI	In Salah Airport
DAUK	Touggourt Sidi Madhi Airport
DAUL	Laghouat Airport
DAUO	Guemar Airport
DAUT	Timimoun Airport
DAUU	Ain el Beida Airport
DAUZ	In AmÃ©nas Airport
DBBB	Cadjehoun Airport
DBC	Baicheng Chang'an Airport
DFFD	Ouagadougou Airport
DFOO	Bobo Dioulasso Airport
DGAA	Kotoka International Airport
DGLE	Tamale Airport
DGSI	Kumasi Airport
DGSN	Sunyani Airport
DGTK	Takoradi Airport
DIAP	Port Bouet Airport
DIBK	BouakÃ© Airport
DIDL	Daloa Airport
DIKO	Korhogo Airport
DIMN	Man Airport
DISP	San Pedro Airport
DIYO	Yamoussoukro Airport
DNAA	Nnamdi Azikiwe International Airport
DNAI	Akwa Ibom International Airport
DNAK	Akure Airport
DNAS	Asaba International Airport
DNBC	Sir Abubakar Tafawa Balewa International Airport
DNBE	Benin Airport
DNCA	Margaret Ekpo International Airport
DNEN	Akanu Ibiam International Airport
DNGU	Gusau Airport
DNIB	Ibadan Airport
DNIL	Ilorin International Airport
DNIM	Sam Mbakwe International Airport
DNJO	Yakubu Gowon Airport
DNKA	Kaduna Airport
DNKN	Mallam Aminu International Airport
DNMA	Maiduguri International Airport
DNMK	Makurdi Airport
DNMM	Murtala Muhammed International Airport
DNMN	Minna Airport
DNPO	Port Harcourt International Airport
DNSO	Sadiq Abubakar III International Airport
DNYO	Yola Airport
DNZA	Zaria Airport
DRRM	Maradi Airport
DRRN	Diori Hamani International Airport
DRRT	Tahoua Airport
DRZA	Mano Dayak International Airport
DRZR	Zinder Airport
DTKA	Tabarka 7 Novembre Airport
DTMB	Monastir Habib Bourguiba International Airport
DTTA	Tunis Carthage International Airport
DTTB	Sidi Ahmed Air Base
DTTD	Remada Air Base
DTTF	Gafsa Ksar International Airport
DTTG	GabÃ¨s Matmata International Airport
DTTJ	Djerba Zarzis International Airport
DTTR	El Borma Airport
DTTX	Sfax Thyna International Airport
DTTZ	Tozeur Nefta International Airport
DXNG	Niamtougou International Airport
DXXX	LomÃ©-Tokoin Airport
EBAW	Antwerp International Airport (Deurne)
EBBE	Beauvechain Air Base
EBBL	Kleine Brogel Air Base
EBBR	Brussels Airport
EBCI	Brussels South Charleroi Airport
EBCV	ChiÃ¨vres Air Base
EBFN	Koksijde Air Base
EBFS	Florennes Air Base
EBKT	Wevelgem Airport
EBLG	LiÃ¨ge Airport
EBOS	Ostend-Bruges International Airport
EDAC	Altenburg-Nobitz Airport
EDAH	Heringsdorf Airport
EDBM	Magdeburg "City" Airport
EDBN	Neubrandenburg Airport
EDBR	Rothenburg/GÃ¶rlitz Airport
EDCD	Cottbus-Drewitz Airport
EDDB	Berlin-SchÃ¶nefeld Airport
EDDC	Dresden Airport
EDDE	Erfurt Airport
EDDF	Frankfurt am Main Airport
EDDG	MÃ¼nster OsnabrÃ¼ck Airport
EDDH	Hamburg Airport
EDDK	Cologne Bonn Airport
EDDL	DÃ¼sseldorf Airport
EDDM	Munich Airport
EDDN	Nuremberg Airport
EDDP	Leipzig/Halle Airport
EDDR	SaarbrÃ¼cken Airport
EDDS	Stuttgart Airport
EDDT	Berlin-Tegel Airport
EDDV	Hannover Airport
EDDW	Bremen Airport
EDFE	Frankfurt-Egelsbach Airport
EDFH	Frankfurt-Hahn Airport
EDFM	Mannheim-City Airport
EDFZ	Mainz-Finthen Airport
EDGE	Eisenach-Kindel Airport
EDGS	Siegerland Airport
EDHI	Hamburg-Finkenwerder Airport
EDHK	Kiel-Holtenau Airport
EDHL	LÃ¼beck Blankensee Airport
EDJA	Memmingen Allgau Airport
EDLN	MÃ¶nchengladbach Airport
EDLP	Paderborn Lippstadt Airport
EDLV	Weeze Airport
EDLW	Dortmund Airport
EDMA	Augsburg Airport
EDMO	Oberpfaffenhofen Airport
EDNY	Friedrichshafen Airport
EDOP	Schwerin Parchim Airport
EDQA	Airport Bamberg-Breitenau
EDQD	Bayreuth Airport
EDQM	Hof-Plauen Airport
EDSB	Karlsruhe Baden-Baden Airport
EDTD	Donaueschingen-Villingen Airport
EDTL	Lahr Airport
EDTY	Adolf WÃ¼rth Airport
EDUZ	Zerbst Airport
EDVE	Braunschweig-Wolfsburg Airport
EDVK	Kassel-Calden Airport
EDXW	Westerland Sylt Airport
EEEI	Ã„mari Air Base
EEKA	KÃ¤rdla Airport
EEKE	Kuressaare Airport
EEPU	PÃ¤rnu Airport
EETN	Lennart Meri Tallinn Airport
EETU	Tartu Airport
EFET	Enontekio Airport
EFHA	Halli Airport
EFHF	Helsinki Malmi Airport
EFHK	Helsinki Vantaa Airport
EFIT	Kitee Airport
EFIV	Ivalo Airport
EFJO	Joensuu Airport
EFJY	Jyvaskyla Airport
EFKA	Kauhava Airport
EFKE	Kemi-Tornio Airport
EFKI	Kajaani Airport
EFKJ	Kauhajoki Airport
EFKK	Kokkola-Pietarsaari Airport
EFKS	Kuusamo Airport
EFKT	KittilÃ¤ Airport
EFKU	Kuopio Airport
EFLP	Lappeenranta Airport
EFMA	Mariehamn Airport
EFMI	Mikkeli Airport
EFOU	Oulu Airport
EFPO	Pori Airport
EFRO	Rovaniemi Airport
EFSA	Savonlinna Airport
EFSI	SeinÃ¤joki Airport
EFSO	Sodankyla Airport
EFTP	Tampere-Pirkkala Airport
EFTU	Turku Airport
EFUT	Utti Air Base
EFVA	Vaasa Airport
EFVR	Varkaus Airport
EFYL	Ylivieska Airfield
EG-0003	Bilbeis 2 Airfield
EGAA	Belfast International Airport
EGAB	St Angelo Airport
EGAC	George Best Belfast City Airport
EGAE	City of Derry Airport
EGBB	Birmingham International Airport
EGBE	Coventry Airport
EGBJ	Gloucestershire Airport
EGBN	Nottingham Airport
EGCC	Manchester Airport
EGCN	Robin Hood Doncaster Sheffield Airport
EGDC	Royal Marines Base Chivenor Airport
EGDM	MoD Boscombe Down Airport
EGDR	RNAS Culdrose
EGDX	MoD St. Athan
EGDY	RNAS Yeovilton
EGEC	Campbeltown Airport
EGED	Eday Airport
EGEF	Fair Isle Airport
EGFE	Haverfordwest Airport
EGFF	Cardiff International Airport
EGFH	Swansea Airport
EGGD	Bristol Airport
EGGP	Liverpool John Lennon Airport
EGGW	London Luton Airport
EGHC	Land's End Airport
EGHE	St. Mary's Airport
EGHH	Bournemouth Airport
EGHI	Southampton Airport
EGHL	Lasham Airport
EGHQ	Newquay Cornwall Airport
EGJA	Alderney Airport
EGJB	Guernsey Airport
EGJJ	Jersey Airport
EGKA	Shoreham Airport
EGKB	London Biggin Hill Airport
EGKK	London Gatwick Airport
EGLC	London City Airport
EGLF	Farnborough Airport
EGLK	Blackbushe Airport
EGLL	London Heathrow Airport
EGMC	Southend Airport
EGMD	Lydd Airport
EGNC	Carlisle Airport
EGNH	Blackpool International Airport
EGNJ	Humberside Airport
EGNL	Barrow Walney Island Airport
EGNM	Leeds Bradford Airport
EGNO	Warton Airport
EGNR	Hawarden Airport
EGNS	Isle of Man Airport
EGNT	Newcastle Airport
EGNV	Durham Tees Valley Airport
EGNX	East Midlands Airport
EGOM	RAF Spadeadam
EGOS	RAF Shawbury
EGOV	Anglesey Airport
EGPA	Kirkwall Airport
EGPB	Sumburgh Airport
EGPC	Wick Airport
EGPD	Aberdeen Dyce Airport
EGPE	Inverness Airport
EGPF	Glasgow International Airport
EGPH	Edinburgh Airport
EGPI	Islay Airport
EGPK	Glasgow Prestwick Airport
EGPL	Benbecula Airport
EGPM	Scatsta Airport
EGPN	Dundee Airport
EGPO	Stornoway Airport
EGPR	Barra Airport
EGPU	Tiree Airport
EGQK	RAF Kinloss
EGQL	RAF Leuchars
EGQS	RAF Lossiemouth
EGSC	Cambridge Airport
EGSH	Norwich International Airport
EGSS	London Stansted Airport
EGTC	Cranfield Airport
EGTE	Exeter International Airport
EGTK	Oxford (Kidlington) Airport
EGUB	RAF Benson
EGUL	RAF Lakenheath
EGUN	RAF Mildenhall
EGUW	Wattisham Airfield
EGUY	RAF Wyton
EGVA	RAF Fairford
EGVN	RAF Brize Norton
EGVO	RAF Odiham
EGWC	DCAE Cosford Air Base
EGWU	RAF Northolt
EGXC	RAF Coningsby
EGXD	RAF Dishforth
EGXE	Leeming Airport
EGXG	Leeds East Airport
EGXH	RAF Honington
EGXP	RAF Scampton
EGXT	RAF Wittering
EGXU	RAF Linton-On-Ouse
EGXW	RAF Waddington
EGXZ	RAF Topcliffe
EGYD	RAF Cranwell
EGYE	RAF Barkston Heath
EGYM	RAF Marham
EGYP	Mount Pleasant Airport
EHAM	Amsterdam Airport Schiphol
EHBD	Budel Airfield Kempen
EHBK	Maastricht Aachen Airport
EHDL	Deelen Air Base
EHDP	De Peel Air Base
EHEH	Eindhoven Airport
EHGG	Eelde Airport
EHGR	Gilze Rijen Air Base
EHKD	De Kooy Airport
EHLE	Lelystad Airport
EHLW	Leeuwarden Air Base
EHRD	Rotterdam The Hague Airport
EHTW	Twente Airport
EHVK	Volkel Air Base
EHWO	Woensdrecht Air Base
EICK	Cork Airport
EICM	Galway Airport
EIDL	Donegal Airport
EIDW	Dublin Airport
EIKN	Ireland West Knock Airport
EIKY	Kerry Airport
EIME	Casement Air Base
EINN	Shannon Airport
EISG	Sligo Airport
EIWF	Waterford Airport
EIWT	Weston Airport
EKAH	Aarhus Airport
EKBI	Billund Airport
EKCH	Copenhagen Kastrup Airport
EKEB	Esbjerg Airport
EKKA	Karup Airport
EKMB	Lolland Falster Maribo Airport
EKOD	Odense Airport
EKRK	Copenhagen Roskilde Airport
EKRN	Bornholm Airport
EKSB	SÃ¸nderborg Airport
EKSN	Sindal Airport
EKSP	Skrydstrup Air Base
EKSV	Skive Airport
EKTS	Thisted Airport
EKVD	Kolding Vamdrup Airfield
EKVG	Vagar Airport
EKVJ	Stauning Airport
EKYT	Aalborg Airport
ELLX	Luxembourg-Findel International Airport
ENAL	Ã…lesund Airport
ENAN	AndÃ¸ya Airport
ENAT	Alta Airport
ENBN	BrÃ¸nnÃ¸ysund Airport
ENBO	BodÃ¸ Airport
ENBR	Bergen Airport Flesland
ENBS	BÃ¥tsfjord Airport
ENBV	BerlevÃ¥g Airport
ENCN	Kristiansand Airport
ENDU	Bardufoss Airport
ENEN	EngelÃ¸y Airport
ENEV	Harstad/Narvik Airport, Evenes
ENFG	Leirin Airport
ENFL	FlorÃ¸ Airport
ENGM	Oslo Gardermoen Airport
ENHD	Haugesund Airport
ENHF	Hammerfest Airport
ENHV	Valan Airport
ENKB	Kristiansund Airport (Kvernberget)
ENKR	Kirkenes Airport (HÃ¸ybuktmoen)
ENLK	Leknes Airport
ENMH	Mehamn Airport
ENML	Molde Airport
ENMS	MosjÃ¸en Airport (KjÃ¦rstad)
ENNA	Banak Airport
ENNK	Narvik Framnes Airport
ENNO	Notodden Airport
ENOL	Ã˜rland Airport
ENOV	Ã˜rsta-Volda Airport, Hovden
ENRA	Mo i Rana Airport, RÃ¸ssvoll
ENRM	RÃ¸rvik Airport, Ryum
ENRO	RÃ¸ros Airport
ENRY	Moss Airport, Rygge
ENSB	Svalbard Airport, Longyear
ENSH	SvolvÃ¦r Helle Airport
ENSK	Stokmarknes Skagen Airport
ENSN	Skien Airport
ENSO	Stord Airport
ENSR	SÃ¸rkjosen Airport
ENSS	VardÃ¸ Airport, Svartnes
ENST	SandnessjÃ¸en Airport (Stokka)
ENTC	TromsÃ¸ Airport
ENTO	Sandefjord Airport, Torp
ENVA	Trondheim Airport VÃ¦rnes
ENVD	VadsÃ¸ Airport
ENZV	Stavanger Airport Sola
EPBP	BiaÅ‚a Podlaska Airfield
EPBY	Bydgoszcz Ignacy Jan Paderewski Airport
EPCE	Cewice Air Base
EPDE	Deblin Military Air Base
EPGD	GdaÅ„sk Lech WaÅ‚Ä™sa Airport
EPIR	Inowroclaw Military Air Base
EPKK	KrakÃ³w John Paul II International Airport
EPKS	Krzesiny Military Air Base
EPKT	Katowice International Airport
EPLK	Lask Military Air Base
EPLL	ÅÃ³dÅº WÅ‚adysÅ‚aw Reymont Airport
EPLY	Leczyca Military Air Base
EPMB	Malbork Military Air Base
EPMI	Miroslawiec Military Air Base
EPMM	Minsk Mazowiecki Military Air Base
EPMO	Modlin Airport
EPOK	Oksywie Military Air Base
EPPO	PoznaÅ„-Åawica Airport
EPPW	Powidz Military Air Base
EPRA	Radom Airport
EPRZ	RzeszÃ³w-Jasionka Airport
EPSC	Szczecin-GoleniÃ³w "SolidarnoÅ›Ä‡" Airport
EPSN	Swidwin Military Air Base
EPSY	Olsztyn-Mazury Airport
EPTM	Tomaszow Mazowiecki Military Air Base
EPWA	Warsaw Chopin Airport
EPWR	Copernicus WrocÅ‚aw Airport
EPZG	Zielona GÃ³ra-Babimost Airport
ESCF	Malmen Air Base
ESDF	Ronneby Airport
ESFR	RÃ¥da Air Base
ESGG	Gothenburg-Landvetter Airport
ESGJ	JÃ¶nkÃ¶ping Airport
ESGP	Gothenburg City Airport
ESGR	SkÃ¶vde Airport
ESGT	TrollhÃ¤ttan-VÃ¤nersborg Airport
ESIB	SÃ¥tenÃ¤s Air Base
ESKK	Karlskoga Airport
ESKM	Mora Airport
ESKN	Stockholm Skavsta Airport
ESKX	BjÃ¶rkvik Air Base
ESMK	Kristianstad Airport
ESMQ	Kalmar Airport
ESMS	MalmÃ¶ Sturup Airport
ESMT	Halmstad Airport
ESMX	VÃ¤xjÃ¶ Kronoberg Airport
ESND	Sveg Airport
ESNG	GÃ¤llivare Airport
ESNK	Kramfors SollefteÃ¥ Airport
ESNL	Lycksele Airport
ESNN	Sundsvall-HÃ¤rnÃ¶sand Airport
ESNO	Ã–rnskÃ¶ldsvik Airport
ESNQ	Kiruna Airport
ESNS	SkellefteÃ¥ Airport
ESNU	UmeÃ¥ Airport
ESNV	Vilhelmina Airport
ESNX	Arvidsjaur Airport
ESNY	SÃ¶derhamn Airport
ESNZ	Ã…re Ã–stersund Airport
ESOE	Ã–rebro Airport
ESOH	Hagfors Airport
ESOK	Karlstad Airport
ESOW	Stockholm VÃ¤sterÃ¥s Airport
ESPA	LuleÃ¥ Airport
ESSA	Stockholm-Arlanda Airport
ESSB	Stockholm-Bromma Airport
ESSD	Borlange Airport
ESSK	GÃ¤vle Sandviken Airport
ESSL	LinkÃ¶ping City Airport
ESSP	NorrkÃ¶ping Airport
ESST	Torsby Airport
ESSU	Eskilstuna Airport
ESSV	Visby Airport
ESTA	Ã„ngelholm-Helsingborg Airport
ESTL	Ljungbyhed Airport
ESUD	Storuman Airport
ESUP	Pajala Airport
ESUT	Hemavan Airport
ETAD	Spangdahlem Air Base
ETAR	Ramstein Air Base
ETHB	BÃ¼ckeburg Air Base
ETHC	Celle Airport
ETHE	Rheine Bentlage Air Base
ETHF	Fritzlar Airport
ETHL	Laupheim Air Base
ETHM	Mendig Airfield
ETHN	Niederstetten Army Air Base
ETHR	Roth Airport
ETHS	Fassberg Air Base
ETIC	Grafenwohr Army Air Field
ETIH	Hohenfels Army Air Field
ETMN	Nordholz Naval Airbase
ETND	Diepholz Air Base
ETNG	Geilenkirchen Air Base
ETNH	Hohn Air Base
ETNJ	Jever Air Base
ETNL	Rostock-Laage Airport
ETNN	NÃ¶rvenich Air Base
ETNS	Schleswig Air Base
ETNT	Wittmundhafen Airport
ETNW	Wunstorf Air Base
ETOU	Wiesbaden Army Airfield
ETSB	BÃ¼chel Air Base
ETSF	FÃ¼rstenfeldbruck Air Base
ETSH	Holzdorf Air Base
ETSI	Ingolstadt Manching Airport
ETSL	Lechfeld Air Base
ETSN	Neuburg AFB
EVDA	Daugavpils Intrenational Airport
EVKA	JÄ“kabpils Air Base
EVLA	LiepÄja International Airport
EVRA	Riga International Airport
EVTA	JÅ«rmala Airport
EVVA	Ventspils International Airport
EYKA	Kaunas International Airport
EYKD	KÄ—dainiai Air Base
EYPA	Palanga International Airport
EYPP	PanevÄ—Å¾ys Air Base
EYSA	Å iauliai International Airport
EYSB	Barysiai Airfield
EYVI	Vilnius International Airport
FAAB	Alexander Bay Airport
FAAG	Aggeneys Airport
FABE	Bisho Airport
FABL	Bram Fischer International Airport
FABR	Barberton Airport
FACT	Cape Town International Airport
FAEL	Ben Schoeman Airport
FAEO	Ermelo Airport
FAFB	Ficksburg Sentraoes Airport
FAGC	Grand Central Airport
FAGG	George Airport
FAGM	Rand Airport
FAHR	Harrismith Airport
FAJS	OR Tambo International Airport
FAKD	P C Pelser Airport
FAKM	Kimberley Airport
FAKN	Kruger Mpumalanga International Airport
FAKU	Johan Pienaar Airport
FAKZ	Kleinsee Airport
FALA	Lanseria Airport
FALC	Lime Acres Finsch Mine Airport
FALE	King Shaka International Airport
FALW	Langebaanweg Airport
FALY	Ladysmith Airport
FAMD	Malamala Airport
FAMG	Margate Airport
FAMM	Mmabatho International Airport
FAMN	Riverside Airport
FAMS	Morningside Farm Airport
FAMU	Mkuze Airport
FANC	Newcastle Airport
FAOH	Oudtshoorn Airport
FAOR	OR Tambo International Airport
FAPE	Port Elizabeth Airport
FAPG	Plettenberg Bay Airport
FAPH	Hendrik Van Eck Airport
FAPI	Pietersburg Municipal Airport
FAPJ	Port St Johns Airport
FAPM	Pietermaritzburg Airport
FAPP	Polokwane International Airport
FAPS	Potchefstroom Airport
FAQT	Queenstown Airport
FARB	Richards Bay Airport
FARG	Rustenburg Airport
FARS	Robertson Airport
FASB	Springbok Airport
FASC	Secunda Airport
FASD	Saldanha /Vredenburg Airport
FASS	Sishen Airport
FASZ	Skukuza Airport
FATZ	Tzaneen Airport
FAUL	Prince Mangosuthu Buthelezi Airport
FAUP	Pierre Van Ryneveld Airport
FAUT	K. D. Matanzima Airport
FAVB	Vryburg Airport
FAVG	Virginia Airport
FAVR	Vredendal Airport
FAVV	Vereeniging Airport
FAWB	Wonderboom Airport
FAWK	Waterkloof Air Force Base
FAYP	Ysterplaat Air Force Base
FBFT	Francistown Airport
FBJW	Jwaneng Airport
FBKE	Kasane Airport
FBMN	Maun Airport
FBSK	Sir Seretse Khama International Airport
FBSN	Sua Pan Airport
FBSP	Selebi Phikwe Airport
FCBB	Maya-Maya Airport
FCOD	Oyo Ollombo Airport
FCOO	Owando Airport
FCOU	Ouesso Airport
FCPL	Ngot Nzoungou Airport
FCPP	Pointe Noire Airport
FDMS	Matsapha Airport
FDSK	King Mswati III International Airport
FEFF	Bangui M'Poko International Airport
FEFT	BerbÃ©rati Airport
FGBT	Bata Airport
FGSL	Malabo Airport
FHAW	RAF Ascension Island
FIMP	Sir Seewoosagur Ramgoolam International Airport
FIMR	Sir Charles Gaetan Duval Airport
FJDG	Diego Garcia Naval Support Facility
FKKC	Tiko Airport
FKKD	Douala International Airport
FKKL	Salak Airport
FKKM	Foumban Nkounja Airport
FKKN	N'GaoundÃ©rÃ© Airport
FKKR	Garoua International Airport
FKKU	Bafoussam Airport
FKKV	Bamenda Airport
FKKY	YaoundÃ© Airport
FKYS	YaoundÃ© Nsimalen International Airport
FLKE	Kasompe Airport
FLLC	Lusaka City Airport
FLLI	Livingstone Airport
FLLS	Kenneth Kaunda International Airport Lusaka
FLMF	Mfuwe Airport
FLMG	Mongu Airport
FLND	Simon Mwansa Kapwepwe International Airport
FLSO	Southdowns Airport
FMCH	Prince Said Ibrahim International Airport
FMCI	MohÃ©li Bandar Es Eslam Airport
FMCV	Ouani Airport
FMCZ	Dzaoudzi Pamandzi International Airport
FMEE	Roland Garros Airport
FMEP	Pierrefonds Airport
FMMI	Ivato Airport
FMMN	Miandrivazo Airport
FMMS	Sainte Marie Airport
FMMT	Toamasina Airport
FMMV	Morondava Airport
FMNA	Arrachart Airport
FMNC	Mananara Nord Airport
FMND	Andapa Airport
FMNH	Antsirabato Airport
FMNL	Analalava Airport
FMNM	Amborovy Airport
FMNN	Fascene Airport
FMNQ	Besalampy Airport
FMNR	Maroantsetra Airport
FMNS	Sambava Airport
FMNV	Vohimarina Airport
FMNW	Ambalabe Airport
FMSD	TÃ´lanaro Airport
FMSF	Fianarantsoa Airport
FMSK	Manakara Airport
FMSM	Mananjary Airport
FMSR	Morombe Airport
FMST	Toliara Airport
FNBC	Mbanza Congo Airport
FNBG	Benguela Airport
FNCA	Cabinda Airport
FNCT	Catumbela Airport
FNDU	Dundo Airport
FNGI	Ngjiva Pereira Airport
FNHU	Nova Lisboa Airport
FNKU	Kuito Airport
FNLU	Quatro de Fevereiro Airport
FNMA	Malanje Airport
FNME	Menongue Airport
FNMO	Namibe Airport
FNNG	Negage Airport
FNPA	Porto Amboim Airport
FNSA	Saurimo Airport
FNSO	Soyo Airport
FNSU	Sumbe Airport
FNUB	Lubango Airport
FNUE	Luena Airport
FNUG	Uige Airport
FNXA	Xangongo Airport
FOGK	Koulamoutou Mabimbi Airport
FOGM	Mouilla Ville Airport
FOGO	Oyem Airport
FOGQ	Okondja Airport
FOGR	Lambarene Airport
FOOB	Bitam Airport
FOOG	Port Gentil Airport
FOOH	Omboue Hopital Airport
FOOK	Makokou Airport
FOOL	Libreville Leon M'ba International Airport
FOON	M'Vengue El Hadj Omar Bongo Ondimba International Airport
FPPR	Principe Airport
FPST	SÃ£o TomÃ© International Airport
FQBR	Beira Airport
FQCH	Chimoio Airport
FQIN	Inhambane Airport
FQLC	Lichinga Airport
FQMA	Maputo Airport
FQMD	Mueda Airport
FQMP	MocÃ­mboa da Praia Airport
FQNP	Nampula Airport
FQPB	Pemba Airport
FQQL	Quelimane Airport
FQTT	Chingozi Airport
FQVL	Vilankulo Airport
FR-0321	Brive Souillac Airport
FSIA	Seychelles International Airport
FSPP	Praslin Airport
FTTC	Abeche Airport
FTTD	Moundou Airport
FTTJ	N'Djamena International Airport
FTTY	Faya Largeau Airport
FVBU	Joshua Mqabuko Nkomo International Airport
FVCZ	Buffalo Range Airport
FVFA	Victoria Falls International Airport
FVHA	Robert Gabriel Mugabe International Airport
FVKB	Kariba International Airport
FVMT	Mutoko Airport
FVMV	Masvingo International Airport
FVTL	Thornhill Air Base
FVWN	Hwange National Park Airport
FWCL	Chileka International Airport
FWDW	Dwangwa Airport
FWKA	Karonga Airport
FWKI	Lilongwe International Airport
FWMG	Mangochi Airport
FWUU	Mzuzu Airport
FXMM	Moshoeshoe I International Airport
FYAR	Arandis Airport
FYGF	Grootfontein Airport
FYKT	Keetmanshoop Airport
FYLZ	Luderitz Airport
FYML	Mariental Airport
FYOA	Ondangwa Airport
FYOG	Oranjemund Airport
FYRU	Rundu Airport
FYTM	Tsumeb Airport
FYWB	Walvis Bay Airport
FYWE	Eros Airport
FYWH	Hosea Kutako International Airport
FZAA	Ndjili International Airport
FZAB	Ndolo Airport
FZBO	Bandundu Airport
FZCA	Kikwit Airport
FZEA	Mbandaka Airport
FZFD	Gbadolite Airport
FZFK	Gemena Airport
FZGA	Lisala Airport
FZIC	Bangoka International Airport
FZJH	Matari Airport
FZKA	Bunia Airport
FZKJ	Buta Zega Airport
FZMA	Bukavu Kavumu Airport
FZNA	Goma International Airport
FZOA	Kindu Airport
FZQA	Lubumbashi International Airport
FZQM	Kolwezi Airport
FZRF	Kalemie Airport
FZSA	Kamina Base Airport
FZUA	Kananga Airport
FZWA	Mbuji Mayi Airport
GABS	Modibo Keita International Airport
GAGO	Gao Airport
GAKY	Kayes Dag Dag Airport
GAMB	Mopti Airport
GATB	Timbuktu Airport
GB-OUK	Outer Skerries Airport
GBYD	Banjul International Airport
GCFV	Fuerteventura Airport
GCHI	Hierro Airport
GCLA	La Palma Airport
GCLP	Gran Canaria Airport
GCRR	Lanzarote Airport
GCTS	Tenerife South Airport
GCXO	Tenerife Norte Airport
GE-0007	Ozurgeti Air Base
GE-0010	Senaki Air Base
GEML	Melilla Airport
GFBN	Sherbro International Airport
GFBO	Bo Airport
GFKE	Kenema Airport
GFLL	Lungi International Airport
GFYE	Yengema Airport
GGOV	Osvaldo Vieira International Airport
GLMR	Spriggs Payne Airport
GLRB	Roberts International Airport
GMAD	Al Massira Airport
GMAT	Tan Tan Airport
GMFB	Bouarfa Airport
GMFF	SaÃ¯ss Airport
GMFK	Moulay Ali Cherif Airport
GMFM	Bassatine Airport
GMFO	Angads Airport
GMMA	Smara Airport
GMME	Rabat-SalÃ© Airport
GMMH	Dakhla Airport
GMML	Hassan I Airport
GMMN	Mohammed V International Airport
GMMW	Nador International Airport
GMMX	Menara Airport
GMMY	Kenitra Airport
GMMZ	Ouarzazate Airport
GMQ	Golog Maqin Airport
GMTA	Cherif Al Idrissi Airport
GMTN	Saniat R'mel Airport
GMTT	Ibn Batouta Airport
GOBD	Blaise Diagne International Airport
GOGG	Ziguinchor Airport
GOGS	Cap Skirring Airport
GOOK	Kaolack Airport
GOOY	LÃ©opold SÃ©dar Senghor International Airport
GOSM	Ouro Sogui Airport
GOSS	Saint Louis Airport
GOTB	Bakel Airport
GOTK	KÃ©dougou Airport
GOTT	Tambacounda Airport
GQNO	Nouakchottâ€“Oumtounsy International Airport
GQPA	Atar International Airport
GQPP	Nouadhibou International Airport
GUCY	Conakry International Airport
GVAC	AmÃ­lcar Cabral International Airport
GVBA	Rabil Airport
GVMA	Maio Airport
GVNP	Praia International Airport
GVSN	PreguiÃ§a Airport
GVSV	SÃ£o Pedro Airport
HAAB	Addis Ababa Bole International Airport
HAAM	Arba Minch Airport
HAAX	Axum Airport
HABD	Bahir Dar Airport
HADR	Aba Tenna Dejazmach Yilma International Airport
HAGM	Gambella Airport
HAGN	Gonder Airport
HAGO	Gode Airport
HAHM	Harar Meda Airport
HAJJ	Wilwal International Airport
HAJM	Jimma Airport
HAMK	Mekele Airport
HASO	Asosa Airport
HBBA	Bujumbura International Airport
HCMH	Egal International Airport
HCMI	Berbera Airport
HCMK	Kisimayu Airport
HCMM	Aden Adde International Airport
HDAM	Djibouti-Ambouli Airport
HE13	Capital International Airport
HE16	Birma Air Base
HE28	Gebel El Basur Air Base
HE35	Abu Suwayr Air Base
HE37	Bilbeis Air Base
HEAL	El Alamein International Airport
HEAR	El Arish International Airport
HEAT	Assiut International Airport
HEAX	El Nouzha Airport
HEAZ	Almaza Air Force Base
HEBA	Borg El Arab International Airport
HEBL	Abu Simbel Airport
HEBS	Beni Suef Air Base
HECA	Cairo International Airport
HECW	Cairo West Airport
HEGN	Hurghada International Airport
HEGR	El Gora Airport
HEGS	Jiyanklis Air Base
HELX	Luxor International Airport
HEMA	Marsa Alam International Airport
HEMK	Sohag International Airport
HEMM	Mersa Matruh Airport
HEPS	Port Said Airport
HESC	St Catherine International Airport
HESH	Sharm El Sheikh International Airport
HESN	Aswan International Airport
HETB	Taba International Airport
HHAS	Asmara International Airport
HHMS	Massawa International Airport
HHSB	Assab International Airport
HIA	Lianshui Airport
HKAM	Amboseli Airport
HKEL	Eldoret International Airport
HKJK	Jomo Kenyatta International Airport
HKKI	Kisumu Airport
HKKT	Kitale Airport
HKLK	Lokichoggio Airport
HKLO	Lodwar Airport
HKLU	Manda Airstrip
HKML	Malindi Airport
HKMO	Mombasa Moi International Airport
HKMS	Mara Serena Lodge Airstrip
HKNW	Nairobi Wilson Airport
HKNY	Nanyuki Airport
HKRE	Moi Air Base
HKWJ	Wajir Airport
HL56	Matan al-Sarra Air Base
HL68	Al Bumbah North Air Base
HL77	Okba Ibn Nafa Air Base
HLGD	Gardabya Airport
HLGT	Ghat Airport
HLKF	Kufra Airport
HLLB	Benina International Airport
HLLM	Mitiga Airport
HLLQ	La Abraq Airport
HLLS	Sabha Airport
HLLT	Tripoli International Airport
HLMB	Marsa Brega Airport
HLTD	Ghadames East Airport
HRYG	Gisenyi Airport
HRYR	Kigali International Airport
HRZA	Kamembe Airport
HSDN	Dongola Airport
HSFA	Paloich Airport, Heliport
HSFS	El Fasher Airport
HSKA	Kassala Airport
HSMN	Merowe New Airport
HSOB	El Obeid Airport
HSPN	Port Sudan New International Airport
HSSJ	Juba International Airport
HSSM	Malakal Airport
HSSS	Khartoum International Airport
HSWW	Wau Airport
HTAR	Arusha Airport
HTDA	Julius Nyerere International Airport
HTDO	Dodoma Airport
HTGW	Songwe Airport
HTIR	Iringa Airport
HTKJ	Kilimanjaro International Airport
HTLM	Lake Manyara Airport
HTMT	Mtwara Airport
HTMW	Mwanza Airport
HTPE	Pemba Airport
HTTG	Tanga Airport
HTZA	Abeid Amani Karume International Airport
HU-0002	Kalocsa/FoktÅ‘ Airport
HUAR	Arua Airport
HUEN	Entebbe International Airport
HUGU	Gulu Airport
HUSO	Soroti Airport
IBL	Indigo Bay Lodge Airport
ID-0017	Sungai Siring International Airport
ID-ZGP	Bilogai-Sugapa Airport
IN-0011	Jakkur Aerodrome
IQ-0016	H1 New Air Base
IQ-0017	H2 Air Base
IQ-0018	H3 Air Base
IQ-0020	H3 Northwest AFB
IQ-0021	H3 Southwest Air Base
IQ-0024	Jalibah Southeast Air Base
IQ-0030	Kut Al Hayy East Air Base
IQ-0034	Qalat Salih Air Base
IQ-0039	Rasheed Air Base
IQ-0040	Ruwayshid Air Base
IQ-0042	Sahl Sinjar Air Base
IQ-0044	Salum Air Base
IQ-0045	Samarra East Air Base
IQ-0051	Tal Ashtah New Air Base
IQ-0054	Tuz Khurmatu Air Base
IQ-0055	Wadi Al Khirr New Air Base
ISG	New Ishigaki Airport
JGD	Jiagedaqi Airport
JIQ	Qianjiang Wulingshan Airport
JJD	Comandante Ariston Pessoa Airport
JNB	O R Tambo International
K79J	South Alabama Regional At Bill Benton Field Airport
KABE	Lehigh Valley International Airport
KABI	Abilene Regional Airport
KABQ	Albuquerque International Sunport
KABR	Aberdeen Regional Airport
KABY	Southwest Georgia Regional Airport
KACK	Nantucket Memorial Airport
KACT	Waco Regional Airport
KACV	California Redwood Coast-Humboldt County Airport
KACY	Atlantic City International Airport
KADW	Joint Base Andrews
KAEX	Alexandria International Airport
KAFW	Fort Worth Alliance Airport
KAGC	Allegheny County Airport
KAGS	Augusta Regional At Bush Field
KAHN	Athens Ben Epps Airport
KAKR	Akron Fulton International Airport
KALB	Albany International Airport
KALI	Alice International Airport
KALM	Alamogordo White Sands Regional Airport
KALN	St Louis Regional Airport
KALO	Waterloo Regional Airport
KALS	San Luis Valley Regional Bergman Field
KALW	Walla Walla Regional Airport
KAMA	Rick Husband Amarillo International Airport
KANB	Anniston Regional Airport
KAND	Anderson Regional Airport
KAOO	Altoona Blair County Airport
KAPA	Centennial Airport
KAPF	Naples Municipal Airport
KAPG	Phillips Army Air Field
KAPN	Alpena County Regional Airport
KARA	Acadiana Regional Airport
KART	Watertown International Airport
KASE	Aspen-Pitkin Co/Sardy Field
KAST	Astoria Regional Airport
KATL	Hartsfield Jackson Atlanta International Airport
KATY	Watertown Regional Airport
KAUG	Augusta State Airport
KAUS	Austin Bergstrom International Airport
KAUW	Wausau Downtown Airport
KAVL	Asheville Regional Airport
KAVP	Wilkes Barre Scranton International Airport
KAXN	Chandler Field
KAZO	Kalamazoo Battle Creek International Airport
KBAB	Beale Air Force Base
KBAD	Barksdale Air Force Base
KBAF	Westfield-Barnes Regional Airport
KBAK	Columbus Municipal Airport
KBBD	Curtis Field
KBCE	Bryce Canyon Airport
KBDE	Baudette International Airport
KBDL	Bradley International Airport
KBDR	Igor I Sikorsky Memorial Airport
KBED	Laurence G Hanscom Field
KBFD	Bradford Regional Airport
KBFF	Western Neb. Rgnl/William B. Heilig Airport
KBFI	Boeing Field King County International Airport
KBFL	Meadows Field
KBFM	Mobile Downtown Airport
KBGM	Greater Binghamton/Edwin A Link field
KBGR	Bangor International Airport
KBHB	Hancock County-Bar Harbor Airport
KBHM	Birmingham-Shuttlesworth International Airport
KBIF	Biggs Army Air Field (Fort Bliss)
KBIH	Eastern Sierra Regional Airport
KBIL	Billings Logan International Airport
KBIS	Bismarck Municipal Airport
KBIX	Keesler Air Force Base
KBJC	Rocky Mountain Metropolitan Airport
KBJI	Bemidji Regional Airport
KBKE	Baker City Municipal Airport
KBKF	Buckley Air Force Base
KBKL	Burke Lakefront Airport
KBKW	Raleigh County Memorial Airport
KBLF	Mercer County Airport
KBLH	Blythe Airport
KBLI	Bellingham International Airport
KBLV	Scott AFB/Midamerica Airport
KBMG	Monroe County Airport
KBMI	Central Illinois Regional Airport at Bloomington-Normal
KBNA	Nashville International Airport
KBNO	Burns Municipal Airport
KBOI	Boise Air Terminal/Gowen Field
KBOS	General Edward Lawrence Logan International Airport
KBPI	Miley Memorial Field
KBPK	Ozark Regional Airport
KBPT	Southeast Texas Regional Airport
KBQK	Brunswick Golden Isles Airport
KBRD	Brainerd Lakes Regional Airport
KBRL	Southeast Iowa Regional Airport
KBRO	Brownsville South Padre Island International Airport
KBTL	W K Kellogg Airport
KBTM	Bert Mooney Airport
KBTR	Baton Rouge Metropolitan Airport
KBTV	Burlington International Airport
KBUF	Buffalo Niagara International Airport
KBUR	Bob Hope Airport
KBVI	Beaver County Airport
KBVY	Beverly Municipal Airport
KBWG	Bowling Green Warren County Regional Airport
KBWI	Baltimore/Washington International Thurgood Marshall Airport
KBYH	Arkansas International Airport
KBYI	Burley Municipal Airport
KBYS	Bicycle Lake Army Air Field
KBZN	Gallatin Field
KCAE	Columbia Metropolitan Airport
KCAK	Akron Canton Regional Airport
KCAR	Caribou Municipal Airport
KCBM	Columbus Air Force Base
KCCY	Northeast Iowa Regional Airport
KCDC	Cedar City Regional Airport
KCDR	Chadron Municipal Airport
KCDS	Childress Municipal Airport
KCEC	Jack Mc Namara Field Airport
KCEF	Westover ARB/Metropolitan Airport
KCEW	Bob Sikes Airport
KCGF	Cuyahoga County Airport
KCGI	Cape Girardeau Regional Airport
KCHA	Lovell Field
KCHO	Charlottesville Albemarle Airport
KCHS	Charleston Air Force Base-International Airport
KCID	The Eastern Iowa Airport
KCIU	Chippewa County International Airport
KCKB	North Central West Virginia Airport
KCLE	Cleveland Hopkins International Airport
KCLL	Easterwood Field
KCLM	William R Fairchild International Airport
KCLT	Charlotte Douglas International Airport
KCMH	John Glenn Columbus International Airport
KCMI	University of Illinois Willard Airport
KCMX	Houghton County Memorial Airport
KCNM	Cavern City Air Terminal
KCNU	Chanute Martin Johnson Airport
KCOD	Yellowstone Regional Airport
KCOE	Coeur D'Alene - Pappy Boyington Field
KCOF	Patrick Air Force Base
KCON	Concord Municipal Airport
KCOS	City of Colorado Springs Municipal Airport
KCOU	Columbia Regional Airport
KCPR	Casper-Natrona County International Airport
KCRE	Grand Strand Airport
KCRG	Jacksonville Executive at Craig Airport
KCRP	Corpus Christi International Airport
KCRQ	Mc Clellan-Palomar Airport
KCRW	Yeager Airport
KCSG	Columbus Metropolitan Airport
KCSV	Crossville Memorial Whitson Field
KCTB	Cut Bank International Airport
KCUB	Jim Hamilton L.B. Owens Airport
KCVG	Cincinnati Northern Kentucky International Airport
KCVO	Corvallis Municipal Airport
KCVS	Cannon Air Force Base
KCWA	Central Wisconsin Airport
KCXO	Conroe-North Houston Regional Airport
KCYS	Cheyenne Regional Jerry Olson Field
KCZ	Kochi Airport (é«˜çŸ¥ç©ºæ¸¯)
KDAA	Davison Army Air Field
KDAB	Daytona Beach International Airport
KDAG	Barstow Daggett Airport
KDAL	Dallas Love Field
KDAN	Danville Regional Airport
KDAY	James M Cox Dayton International Airport
KDBQ	Dubuque Regional Airport
KDCA	Ronald Reagan Washington National Airport
KDDC	Dodge City Regional Airport
KDEC	Decatur Airport
KDEN	Denver International Airport
KDET	Coleman A. Young Municipal Airport
KDFW	Dallas Fort Worth International Airport
KDHN	Dothan Regional Airport
KDHT	Dalhart Municipal Airport
KDIK	Dickinson Theodore Roosevelt Regional Airport
KDLF	DLF Airport
KDLH	Duluth International Airport
KDLS	Columbia Gorge Regional the Dalles Municipal Airport
KDMA	Davis Monthan Air Force Base
KDMN	Deming Municipal Airport
KDNL	Daniel Field
KDOV	Dover Air Force Base
KDPA	Dupage Airport
KDRA	Desert Rock Airport
KDRI	Beauregard Regional Airport
KDRT	Del Rio International Airport
KDSM	Des Moines International Airport
KDTW	Detroit Metropolitan Wayne County Airport
KDUG	Bisbee Douglas International Airport
KDUJ	DuBois Regional Airport
KDYS	Dyess Air Force Base
KE-0075	Laikipia Air Base
KEAT	Pangborn Memorial Airport
KEAU	Chippewa Valley Regional Airport
KECG	Elizabeth City Regional Airport & Coast Guard Air Station
KECP	Northwest Florida Beaches International Airport
KEDW	Edwards Air Force Base
KEED	Needles Airport
KEEN	Dillant Hopkins Airport
KEET	Shelby County Airport
KEFD	Ellington Airport
KEGE	Eagle County Regional Airport
KEGI	Duke Field
KEKA	Murray Field
KEKN	Elkins-Randolph Co-Jennings Randolph Field
KEKO	Elko Regional Airport
KELD	South Arkansas Regional At Goodwin Field
KELM	Elmira Corning Regional Airport
KELO	Ely Municipal Airport
KELP	El Paso International Airport
KELY	Ely Airport Yelland Field
KEND	Vance Air Force Base
KENV	Wendover Airport
KENW	Kenosha Regional Airport
KERI	Erie International Tom Ridge Field
KESF	Esler Regional Airport
KEUG	Mahlon Sweet Field
KEVV	Evansville Regional Airport
KEVW	Evanston-Uinta County Airport-Burns Field
KEWB	New Bedford Regional Airport
KEWN	Coastal Carolina Regional Airport
KEWR	Newark Liberty International Airport
KEYW	Key West International Airport
KFAF	Felker Army Air Field
KFAR	Hector International Airport
KFAT	Fresno Yosemite International Airport
KFAY	Fayetteville Regional Grannis Field
KFBG	Simmons Army Air Field
KFCS	Butts AAF (Fort Carson) Air Field
KFDY	Findlay Airport
KFFO	Wright-Patterson Air Force Base
KFHU	Sierra Vista Municipal Libby Army Air Field
KFKL	Venango Regional Airport
KFLG	Flagstaff Pulliam Airport
KFLL	Fort Lauderdale Hollywood International Airport
KFLO	Florence Regional Airport
KFME	Tipton Airport
KFMN	Four Corners Regional Airport
KFMY	Page Field
KFNT	Bishop International Airport
KFOD	Fort Dodge Regional Airport
KFOE	Topeka Regional Airport - Forbes Field
KFPR	St Lucie County International Airport
KFRG	Republic Airport
KFRI	Marshall Army Air Field
KFSD	Joe Foss Field Airport
KFSI	Henry Post Army Air Field (Fort Sill)
KFSM	Fort Smith Regional Airport
KFST	Fort Stockton Pecos County Airport
KFTK	Godman Army Air Field
KFTW	Fort Worth Meacham International Airport
KFTY	Fulton County Airport Brown Field
KFWA	Fort Wayne International Airport
KFXE	Fort Lauderdale Executive Airport
KFYV	Drake Field
KG-0001	Jalal-Abad Airport
KGCC	Gillette Campbell County Airport
KGCK	Garden City Regional Airport
KGCN	Grand Canyon National Park Airport
KGDV	Dawson Community Airport
KGEG	Spokane International Airport
KGFK	Grand Forks International Airport
KGFL	Floyd Bennett Memorial Airport
KGGG	East Texas Regional Airport
KGGW	Wokal Field Glasgow International Airport
KGJT	Grand Junction Regional Airport
KGLD	Renner Field-Goodland Municipal Airport
KGLH	Mid Delta Regional Airport
KGLS	Scholes International At Galveston Airport
KGMU	Greenville Downtown Airport
KGNV	Gainesville Regional Airport
KGON	Groton New London Airport
KGPI	Glacier Park International Airport
KGPT	Gulfport Biloxi International Airport
KGRB	Austin Straubel International Airport
KGRF	Gray Army Air Field
KGRI	Central Nebraska Regional Airport
KGRK	Robert Gray  Army Air Field Airport
KGRR	Gerald R. Ford International Airport
KGSB	Seymour Johnson Air Force Base
KGSO	Piedmont Triad International Airport
KGSP	Greenville Spartanburg International Airport
KGTB	Wheeler Sack Army Air Field
KGTF	Great Falls International Airport
KGTR	Golden Triangle Regional Airport
KGUP	Gallup Municipal Airport
KGUS	Grissom Air Reserve Base
KGUY	Guymon Municipal Airport
KGWO	Greenwoodâ€“Leflore Airport
KGYY	Gary Chicago International Airport
KHBG	Hattiesburg Bobby L Chain Municipal Airport
KHBR	Hobart Regional Airport
KHFD	Hartford Brainard Airport
KHGR	Hagerstown Regional Richard A Henson Field
KHHR	Jack Northrop Field Hawthorne Municipal Airport
KHIB	Range Regional Airport
KHIF	Hill Air Force Base
KHIO	Portland Hillsboro Airport
KHKY	Hickory Regional Airport
KHLG	Wheeling Ohio County Airport
KHLN	Helena Regional Airport
KHLR	Hood Army Air Field
KHMN	Holloman Air Force Base
KHOB	Lea County Regional Airport
KHON	Huron Regional Airport
KHOP	Campbell AAF (Fort Campbell) Air Field
KHOT	Memorial Field
KHOU	William P Hobby Airport
KHPN	Westchester County Airport
KHQM	Bowerman Airport
KHRL	Valley International Airport
KHRO	Boone County Airport
KHRT	Hurlburt Field
KHST	Homestead ARB Airport
KHSV	Huntsville International Carl T Jones Field
KHTS	Tri-State/Milton J. Ferguson Field
KHUA	Redstone Army Air Field
KHUF	Terre Haute Regional Airport, Hulman Field
KHUL	Houlton International Airport
KHUT	Hutchinson Municipal Airport
KHVN	Tweed New Haven Airport
KHVR	Havre City County Airport
KHYA	Barnstable Municipal Boardman Polando Field
KHYI	San Marcos Regional Airport
KHYR	Sawyer County Airport
KHYS	Hays Regional Airport
KIAB	Mc Connell Air Force Base
KIAD	Washington Dulles International Airport
KIAG	Niagara Falls International Airport
KIAH	George Bush Intercontinental Houston Airport
KICT	Wichita Eisenhower National Airport
KIDA	Idaho Falls Regional Airport
KIKK	Greater Kankakee Airport
KILG	New Castle Airport
KILM	Wilmington International Airport
KILN	Wilmington Airpark
KIND	Indianapolis International Airport
KINK	Winkler County Airport
KINL	Falls International Airport
KINT	Smith Reynolds Airport
KINW	Winslow Lindbergh Regional Airport
KIPL	Imperial County Airport
KIPT	Williamsport Regional Airport
KIRK	Kirksville Regional Airport
KISM	Kissimmee Gateway Airport
KISN	Sloulin Field International Airport
KISO	Kinston Regional Jetport At Stallings Field
KISP	Long Island Mac Arthur Airport
KITH	Ithaca Tompkins Regional Airport
KIWA	Phoenix-Mesa-Gateway Airport
KJAC	Jackson Hole Airport
KJAN	Jackson-Medgar Wiley Evers International Airport
KJAX	Jacksonville International Airport
KJBR	Jonesboro Municipal Airport
KJCT	Kimble County Airport
KJFK	John F Kennedy International Airport
KJHW	Chautauqua County-Jamestown Airport
KJKL	Julian Carroll Airport
KJLN	Joplin Regional Airport
KJMS	Jamestown Regional Airport
KJST	John Murtha Johnstown Cambria County Airport
KJXN	Jackson County Reynolds Field
KKLS	Southwest Washington Regional Airport
KLAF	Purdue University Airport
KLAL	Lakeland Linder International Airport
KLAN	Capital City Airport
KLAR	Laramie Regional Airport
KLAS	McCarran International Airport
KLAW	Lawton Fort Sill Regional Airport
KLAX	Los Angeles International Airport
KLBB	Lubbock Preston Smith International Airport
KLBE	Arnold Palmer Regional Airport
KLBF	North Platte Regional Airport Lee Bird Field
KLBL	Liberal Mid-America Regional Airport
KLBT	Lumberton Regional Airport
KLBX	Texas Gulf Coast Regional Airport
KLCH	Lake Charles Regional Airport
KLCK	Rickenbacker International Airport
KLEB	Lebanon Municipal Airport
KLEE	Leesburg International Airport
KLEX	Blue Grass Airport
KLFI	Langley Air Force Base
KLFK	Angelina County Airport
KLFT	Lafayette Regional Airport
KLGA	La Guardia Airport
KLGB	Long Beach /Daugherty Field/ Airport
KLGU	Logan-Cache Airport
KLIT	Bill & Hillary Clinton National Airport/Adams Field
KLLQ	Monticello Municipal Ellis Field
KLMT	Crater Lake-Klamath Regional Airport
KLND	Hunt Field
KLNK	Lincoln Airport
KLNS	Lancaster Airport
KLOL	Derby Field
KLOU	Bowman Field
KLOZ	London-Corbin Airport/Magee Field
KLRD	Laredo International Airport
KLRF	Little Rock Air Force Base
KLRU	Las Cruces International Airport
KLSE	La Crosse Municipal Airport
KLSF	Lawson Army Air Field (Fort Benning)
KLSV	Nellis Air Force Base
KLTS	Altus Air Force Base
KLUF	Luke Air Force Base
KLUK	Cincinnati Municipal Airport Lunken Field
KLVM	Mission Field
KLVS	Las Vegas Municipal Airport
KLWB	Greenbrier Valley Airport
KLWM	Lawrence Municipal Airport
KLWS	Lewiston Nez Perce County Airport
KLWT	Lewistown Municipal Airport
KLYH	Lynchburg Regional Preston Glenn Field
KMAF	Midland International Airport
KMBG	Mobridge Municipal Airport
KMBS	MBS International Airport
KMCB	Mc Comb/Pike County Airport/John E Lewis Field
KMCC	Mc Clellan Airfield
KMCE	Merced Regional Macready Field
KMCF	Mac Dill Air Force Base
KMCI	Kansas City International Airport
KMCK	Mc Cook Ben Nelson Regional Airport
KMCN	Middle Georgia Regional Airport
KMCO	Orlando International Airport
KMCW	Mason City Municipal Airport
KMDH	Southern Illinois Airport
KMDT	Harrisburg International Airport
KMDW	Chicago Midway International Airport
KMEI	Key Field
KMEM	Memphis International Airport
KMER	Castle Airport
KMFD	Mansfield Lahm Regional Airport
KMFE	Mc Allen Miller International Airport
KMFR	Rogue Valley International Medford Airport
KMGE	Dobbins Air Reserve Base
KMGM	Montgomery Regional (Dannelly Field) Airport
KMGW	Morgantown Municipal Walter L. Bill Hart Field
KMHK	Manhattan Regional Airport
KMHR	Sacramento Mather Airport
KMHT	Manchester-Boston Regional Airport
KMIA	Miami International Airport
KMIB	Minot Air Force Base
KMIE	Delaware County Johnson Field
KMIV	Millville Municipal Airport
KMKC	Charles B. Wheeler Downtown Airport
KMKE	General Mitchell International Airport
KMKL	McKellar-Sipes Regional Airport
KMLB	Melbourne International Airport
KMLC	Mc Alester Regional Airport
KMLI	Quad City International Airport
KMLS	Frank Wiley Field
KMLU	Monroe Regional Airport
KMMT	Mc Entire Joint National Guard Base
KMMU	Morristown Municipal Airport
KMMV	Mc Minnville Municipal Airport
KMOB	Mobile Regional Airport
KMOD	Modesto City Co-Harry Sham Field
KMOT	Minot International Airport
KMPV	Edward F Knapp State Airport
KMQY	Smyrna Airport
KMRB	Eastern WV Regional Airport/Shepherd Field
KMRY	Monterey Peninsula Airport
KMSL	Northwest Alabama Regional Airport
KMSN	Dane County Regional Truax Field
KMSO	Missoula International Airport
KMSP	Minneapolis-St Paul International/Wold-Chamberlain Airport
KMSS	Massena International Richards Field
KMSY	Louis Armstrong New Orleans International Airport
KMTC	Selfridge Air National Guard Base Airport
KMTH	The Florida Keys Marathon Airport
KMTJ	Montrose Regional Airport
KMTN	Martin State Airport
KMUI	Muir Army Air Field (Fort Indiantown Gap) Airport
KMUO	Mountain Home Air Force Base
KMWH	Grant County International Airport
KMXF	Maxwell Air Force Base
KMYL	McCall Municipal Airport
KMYR	Myrtle Beach International Airport
KMYV	Yuba County Airport
KNBC	Beaufort MCAS - Merritt Field
KNBG	New Orleans NAS JRB/Alvin Callender Field
KNCA	New River MCAS /H/ /Mccutcheon Fld/ Airport
KNDZ	Whiting Field Naval Air Station South Airport
KNEL	Lakehurst Maxfield Field Airport
KNEW	Lakefront Airport
KNFG	Camp Pendleton MCAS (Munn Field) Airport
KNFL	Fallon Naval Air Station
KNFW	NAS Fort Worth JRB/Carswell Field
KNGP	Corpus Christi Naval Air Station/Truax Field
KNGU	Norfolk Naval Station (Chambers Field)
KNHK	Patuxent River Naval Air Station (Trapnell Field)
KNHZ	Brunswick Executive Airport
KNID	China Lake Naws (Armitage Field) Airport
KNIP	Jacksonville Naval Air Station (Towers Field)
KNJK	El Centro NAF Airport (Vraciu Field)
KNKT	Cherry Point MCAS /Cunningham Field/
KNKX	Miramar Marine Corps Air Station - Mitscher Field
KNLC	Lemoore Naval Air Station (Reeves Field) Airport
KNMM	Meridian Naval Air Station
KNPA	Pensacola Naval Air Station/Forrest Sherman Field
KNQA	Millington-Memphis Airport
KNQI	Kingsville Naval Air Station
KNQX	Naval Air Station Key West/Boca Chica Field
KNRB	Naval Station Mayport (Admiral David L. Mcdonald Field)
KNSE	Whiting Field Naval Air Station - North
KNTD	Point Mugu Naval Air Station (Naval Base Ventura Co)
KNTU	Oceana Naval Air Station
KNUQ	Moffett Federal Airfield
KNUW	Whidbey Island Naval Air Station (Ault Field)
KNXP	Twentynine Palms (Self) Airport
KNYG	Quantico MCAF /Turner field
KNYL	Yuma MCAS/Yuma International Airport
KNZY	North Island Naval Air Station-Halsey Field
KOAJ	Albert J Ellis Airport
KOAK	Metropolitan Oakland International Airport
KOFF	Offutt Air Force Base
KOFK	Karl Stefan Memorial Airport
KOGB	Orangeburg Municipal Airport
KOGD	Ogden Hinckley Airport
KOKC	Will Rogers World Airport
KOLF	L M Clayton Airport
KOLM	Olympia Regional Airport
KOLS	Nogales International Airport
KOLU	Columbus Municipal Airport
KOMA	Eppley Airfield
KONP	Newport Municipal Airport
KONT	Ontario International Airport
KOPF	Opa-locka Executive Airport
KOQU	Quonset State Airport
KORD	Chicago O'Hare International Airport
KORF	Norfolk International Airport
KORH	Worcester Regional Airport
KOSH	Wittman Regional Airport
KOSU	The Ohio State University Airport - Don Scott Field
KOTH	Southwest Oregon Regional Airport
KOTM	Ottumwa Regional Airport
KOWB	Owensboro Daviess County Airport
KOWD	Norwood Memorial Airport
KOXR	Oxnard Airport
KOZR	Cairns AAF (Fort Rucker) Air Field
KP-0002	Haeju Airfield
KP-0012	Kwaksan Air Base
KP-0015	Koksan Air Base
KP-0020	Hwangju Airbase
KP-0022	Pukchang Air Base
KP-0025	Toksan Air Base
KP-0032	Orang Airport
KP-0035	Hwangsuwon Airbase
KP-0036	Changjin Air Force Base
KP-0038	Riwon Airbase
KP-0039	Kwail Air Base
KP-0041	Uthachi Highway Strip Airport
KP-0068	Koksan 2 Highway Strip
KPAE	Snohomish County (Paine Field) Airport
KPAH	Barkley Regional Airport
KPAM	Tyndall Air Force Base
KPBF	Pine Bluff Regional Airport, Grider Field
KPBG	Plattsburgh International Airport
KPBI	Palm Beach International Airport
KPDK	DeKalb Peachtree Airport
KPDT	Eastern Oregon Regional At Pendleton Airport
KPDX	Portland International Airport
KPGA	Page Municipal Airport
KPGV	Pitt Greenville Airport
KPHF	Newport News Williamsburg International Airport
KPHL	Philadelphia International Airport
KPHX	Phoenix Sky Harbor International Airport
KPIA	General Wayne A. Downing Peoria International Airport
KPIB	Hattiesburg Laurel Regional Airport
KPIE	St Petersburg Clearwater International Airport
KPIH	Pocatello Regional Airport
KPIR	Pierre Regional Airport
KPIT	Pittsburgh International Airport
KPKB	Mid Ohio Valley Regional Airport
KPLN	Pellston Regional Airport of Emmet County Airport
KPMD	Palmdale Regional/USAF Plant 42 Airport
KPNA	Ralph Wenz Field
KPNC	Ponca City Regional Airport
KPNE	Northeast Philadelphia Airport
KPNS	Pensacola Regional Airport
KPOB	Pope Field
KPOE	Polk Army Air Field
KPOU	Dutchess County Airport
KPQI	Northern Maine Regional Airport at Presque Isle
KPRB	Paso Robles Municipal Airport
KPRC	Ernest A. Love Field
KPRX	Cox Field
KPSC	Tri Cities Airport
KPSM	Portsmouth International at Pease Airport
KPSP	Palm Springs International Airport
KPTK	Oakland County International Airport
KPUW	Pullman Moscow Regional Airport
KPVD	Theodore Francis Green State Airport
KPVU	Provo Municipal Airport
KPWK	Chicago Executive Airport
KPWM	Portland International Jetport Airport
KPWT	Bremerton National Airport
KRAL	Riverside Municipal Airport
KRAP	Rapid City Regional Airport
KRBL	Red Bluff Municipal Airport
KRCA	Ellsworth Air Force Base
KRDD	Redding Municipal Airport
KRDG	Reading Regional Carl A Spaatz Field
KRDM	Roberts Field
KRDR	Grand Forks Air Force Base
KRDU	Raleigh Durham International Airport
KRFD	Chicago Rockford International Airport
KRHI	Rhinelander Oneida County Airport
KRIC	Richmond International Airport
KRIL	Garfield County Regional Airport
KRIV	March ARB Airport
KRIW	Riverton Regional Airport
KRKS	Southwest Wyoming Regional Airport
KRME	Griffiss International Airport
KRMG	Richard B Russell Airport
KRND	Randolph Air Force Base
KRNH	New Richmond Regional Airport
KRNO	Reno Tahoe International Airport
KROA	Roanokeâ€“Blacksburg Regional Airport
KROC	Greater Rochester International Airport
KROW	Roswell International Air Center Airport
KRSL	Russell Municipal Airport
KRST	Rochester International Airport
KRSW	Southwest Florida International Airport
KRUT	Rutland - Southern Vermont Regional Airport
KRVS	Richard Lloyd Jones Jr Airport
KRWF	Redwood Falls Municipal Airport
KRWI	Rocky Mount Wilson Regional Airport
KRWL	Rawlins Municipal Airport/Harvey Field
KRYY	Cobb County-Mc Collum Field
KSAC	Sacramento Executive Airport
KSAF	Santa Fe Municipal Airport
KSAN	San Diego International Airport
KSAT	San Antonio International Airport
KSAV	Savannah Hilton Head International Airport
KSAW	Sawyer International Airport
KSBA	Santa Barbara Municipal Airport
KSBD	San Bernardino International Airport
KSBN	South Bend Regional Airport
KSBP	San Luis County Regional Airport
KSBY	Salisbury Ocean City Wicomico Regional Airport
KSCH	Schenectady County Airport
KSCK	Stockton Metropolitan Airport
KSDF	Louisville International Standiford Field
KSDM	Brown Field Municipal Airport
KSDY	Sidney - Richland Regional Airport
KSEA	Seattle Tacoma International Airport
KSFB	Orlando Sanford International Airport
KSFF	Felts Field
KSFO	San Francisco International Airport
KSGF	Springfield Branson National Airport
KSGH	Springfield-Beckley Municipal Airport
KSGJ	Northeast Florida Regional Airport
KSGR	Sugar Land Regional Airport
KSGU	St George Municipal Airport
KSHR	Sheridan County Airport
KSHV	Shreveport Regional Airport
KSJC	Norman Y. Mineta San Jose International Airport
KSJT	San Angelo Regional Mathis Field
KSKA	Fairchild Air Force Base
KSKF	Lackland Air Force Base
KSLC	Salt Lake City International Airport
KSLE	Salem Municipal Airport/McNary Field
KSLI	Los Alamitos Army Air Field
KSLK	Adirondack Regional Airport
KSLN	Salina Municipal Airport
KSME	Lake Cumberland Regional Airport
KSMF	Sacramento International Airport
KSMN	Lemhi County Airport
KSMX	Santa Maria Pub/Capt G Allan Hancock Field
KSNA	John Wayne Airport-Orange County Airport
KSNS	Salinas Municipal Airport
KSNY	Sidney Municipal-Lloyd W Carr Field
KSOA	Sonora Municipal Airport
KSPI	Abraham Lincoln Capital Airport
KSPS	Sheppard Air Force Base-Wichita Falls Municipal Airport
KSRQ	Sarasota Bradenton International Airport
KSRR	Sierra Blanca Regional Airport
KSSC	Shaw Air Force Base
KSSF	Stinson Municipal Airport
KSSI	Malcolm McKinnon Airport
KSTC	St Cloud Regional Airport
KSTJ	Rosecrans Memorial Airport
KSTL	St Louis Lambert International Airport
KSTP	St Paul Downtown Holman Field
KSTS	Charles M. Schulz Sonoma County Airport
KSUN	Friedman Memorial Airport
KSUS	Spirit of St Louis Airport
KSUU	Travis Air Force Base
KSUX	Sioux Gateway Col. Bud Day Field
KSUZ	Saline County Regional Airport
KSVN	Hunter Army Air Field
KSWF	Stewart International Airport
KSWO	Stillwater Regional Airport
KSYR	Syracuse Hancock International Airport
KSZL	Whiteman Air Force Base
KTBN	Waynesville-St. Robert Regional Forney field
KTCC	Tucumcari Municipal Airport
KTCL	Tuscaloosa Regional Airport
KTCM	McChord Air Force Base
KTCS	Truth Or Consequences Municipal Airport
KTEB	Teterboro Airport
KTIK	Tinker Air Force Base
KTIW	Tacoma Narrows Airport
KTIX	Space Coast Regional Airport
KTLH	Tallahassee Regional Airport
KTMB	Kendall-Tamiami Executive Airport
KTOI	Troy Municipal Airport at N Kenneth Campbell Field
KTOL	Toledo Express Airport
KTOP	Philip Billard Municipal Airport
KTPA	Tampa International Airport
KTPH	Tonopah Airport
KTPL	Draughon Miller Central Texas Regional Airport
KTRI	Tri-Cities Regional TN/VA Airport
KTRK	Truckee Tahoe Airport
KTRM	Jacqueline Cochran Regional Airport
KTTD	Portland Troutdale Airport
KTTN	Trenton Mercer Airport
KTTS	Nasa Shuttle Landing Facility Airport
KTUL	Tulsa International Airport
KTUP	Tupelo Regional Airport
KTUS	Tucson International Airport
KTVC	Cherry Capital Airport
KTVL	Lake Tahoe Airport
KTWF	Joslin Field Magic Valley Regional Airport
KTXK	Texarkana Regional Webb Field
KTYR	Tyler Pounds Regional Airport
KTYS	McGhee Tyson Airport
KUAO	Aurora State Airport
KUIN	Quincy Regional Baldwin Field
KUKI	Ukiah Municipal Airport
KUNV	University Park Airport
KUOX	University Oxford Airport
KUTS	Huntsville Regional Airport
KVAD	Moody Air Force Base
KVBG	Vandenberg Air Force Base
KVCT	Victoria Regional Airport
KVEL	Vernal Regional Airport
KVGT	North Las Vegas Airport
KVLD	Valdosta Regional Airport
KVNY	Van Nuys Airport
KVOK	Volk Field
KVPS	Destin-Ft Walton Beach Airport
KVPZ	Porter County Municipal Airport
KVRB	Vero Beach Regional Airport
KVTN	Miller Field
KW63	Lake Country Regional Airport
KWJF	General WM J Fox Airfield
KWMC	Winnemucca Municipal Airport
KWRB	Robins Air Force Base
KWRI	Mc Guire Air Force Base
KWRL	Worland Municipal Airport
KWWD	Cape May County Airport
KWWR	West Woodward Airport
KWY	Kiwayu Airport
KWYS	Yellowstone Airport
KXMR	Cape Canaveral AFS Skid Strip
KXNA	Northwest Arkansas Regional Airport
KXTA	Homey (Area 51) Airport
KYIP	Willow Run Airport
KYKM	Yakima Air Terminal McAllister Field
KYKN	Chan Gurney Municipal Airport
KYNG	Youngstown Warren Regional Airport
KZ-0016	Taldykorgan Airport
KZ-0067	Krainiy Airport
KZ-0068	Kurchatov Airfield
KZ-0069	Zhangiztobe Air Base
KZ-7470	Dolon Air Base
KZZV	Zanesville Municipal Airport
LAKU	KukÃ«s Airport
LAKV	KuÃ§ovÃ« Air Base
LATI	Tirana International Airport Mother Teresa
LAVL	VlorÃ« Air Base
LBBG	Burgas Airport
LBGO	Gorna Oryahovitsa Airport
LBHS	Haskovo Malevo Airport
LBMG	Gabrovnitsa Air Base
LBPD	Plovdiv International Airport
LBPG	Graf Ignatievo Air Base
LBPL	Dolna Mitropoliya Air Base
LBSF	Sofia Airport
LBWB	Balchik Air Base
LBWN	Varna Airport
LCEN	Ercan International Airport
LCLK	Larnaca International Airport
LCPH	Paphos International Airport
LCRA	RAF Akrotiri
LDDU	Dubrovnik Airport
LDOS	Osijek Airport
LDPL	Pula Airport
LDRI	Rijeka Airport
LDSB	Bol Airport
LDSP	Split Airport
LDZA	Zagreb Airport
LDZD	Zadar Airport
LEAB	Albacete-Los Llanos Airport
LEAL	Alicante International Airport
LEAM	AlmerÃ­a International Airport
LEAS	Asturias Airport
LEBA	CÃ³rdoba Airport
LEBB	Bilbao Airport
LEBG	Burgos Airport
LEBL	Barcelona International Airport
LEBZ	Badajoz Airport
LECH	CastellÃ³n-Costa Azahar Airport
LECO	A CoruÃ±a Airport
LECU	Cuatro Vientos Airport
LEDA	Lleida-Alguaire Airport
LEDS	CastellÃ³n-Costa Azahar Airport
LEGA	Armilla Air Base
LEGE	Girona Airport
LEGR	Federico Garcia Lorca Airport
LEGT	Getafe Air Base
LEIB	Ibiza Airport
LEJR	Jerez Airport
LELC	San Javier Airport
LELN	Leon Airport
LEMD	Adolfo SuÃ¡rez Madridâ€“Barajas Airport
LEMG	MÃ¡laga Airport
LEMH	Menorca Airport
LEMO	Moron Air Base
LEPA	Palma De Mallorca Airport
LEPP	Pamplona Airport
LERI	Alcantarilla Air Base
LERS	Reus Air Base
LERT	Rota Naval Station Airport
LESA	Salamanca Airport
LESO	San Sebastian Airport
LEST	Santiago de Compostela Airport
LETL	Teruel Airport
LETO	TorrejÃ³n Airport
LEVC	Valencia Airport
LEVD	Valladolid Airport
LEVT	Vitoria/Foronda Airport
LEVX	Vigo Airport
LEXJ	Santander Airport
LEZG	Zaragoza Air Base
LEZL	Sevilla Airport
LFAC	Calais-Dunkerque Airport
LFAG	PÃ©ronne-Saint-Quentin Airport
LFAT	Le Touquet-CÃ´te d'Opale Airport
LFAV	Valenciennes-Denain Airport
LFAY	Amiens-Glisy Airport
LFBA	Agen-La Garenne Airport
LFBC	Cazaux (BA 120) Air Base
LFBD	Bordeaux-MÃ©rignac Airport
LFBE	Bergerac-RoumaniÃ¨re Airport
LFBF	Toulouse-Francazal (BA 101) Air Base
LFBG	Cognac-ChÃ¢teaubernard (BA 709) Air Base
LFBH	La Rochelle-ÃŽle de RÃ© Airport
LFBI	Poitiers-Biard Airport
LFBK	MontluÃ§on-GuÃ©ret Airport
LFBL	Limoges Airport
LFBM	Mont-de-Marsan (BA 118) Air Base
LFBN	Niort-SouchÃ© Airport
LFBO	Toulouse-Blagnac Airport
LFBP	Pau PyrÃ©nÃ©es Airport
LFBT	Tarbes-Lourdes-PyrÃ©nÃ©es Airport
LFBU	AngoulÃªme-Brie-Champniers Airport
LFBX	PÃ©rigueux-Bassillac Airport
LFBZ	Biarritz-Anglet-Bayonne Airport
LFCC	Cahors-Lalbenque Airport
LFCG	Saint-Girons-Antichan Airport
LFCH	Arcachon-La Teste-de-Buch Airport
LFCI	Albi-Le SÃ©questre Airport
LFCK	Castres-Mazamet Airport
LFCR	Rodez-Marcillac Airport
LFCY	Royan-MÃ©dis Airport
LFDB	Montauban Airport
LFDH	Auch-Lamothe Airport
LFDI	Libourne-Artigues-de-Lussac Airport
LFDN	Rochefort-Saint-Agnant (BA 721) Airport
LFEY	ÃŽle d'Yeu Airport
LFGA	Colmar-Houssen Airport
LFGJ	Dole-Tavaux Airport
LFGW	Verdun-Le Rozelier Airfield
LFHO	Aubenas-ArdÃ¨che MÃ©ridional Airport
LFHP	Le Puy-Loudes Airport
LFJL	Metz-Nancy-Lorraine Airport
LFJR	Angers-Loire Airport
LFKB	Bastia-Poretta Airport
LFKC	Calvi-Sainte-Catherine Airport
LFKF	Figari Sud-Corse Airport
LFKJ	Ajaccio-NapolÃ©on Bonaparte Airport
LFKS	Solenzara (BA 126) Air Base
LFLA	Auxerre-Branches Airport
LFLB	ChambÃ©ry-Savoie Airport
LFLC	Clermont-Ferrand Auvergne Airport
LFLD	Bourges Airport
LFLH	Chalon-Champforgeuil Airport
LFLI	Annemasse Airport
LFLL	Lyon Saint-ExupÃ©ry Airport
LFLM	MÃ¢con-Charnay Airport
LFLN	Saint-Yan Airport
LFLO	Roanne-Renaison Airport
LFLP	Annecy-Haute-Savoie-Mont Blanc Airport
LFLS	Grenoble-IsÃ¨re Airport
LFLU	Valence-Chabeuil Airport
LFLV	Vichy-Charmeil Airport
LFLW	Aurillac Airport
LFLX	ChÃ¢teauroux-DÃ©ols "Marcel Dassault" Airport
LFLY	Lyon-Bron Airport
LFMC	Le Luc-Le Cannet Airport
LFMD	Cannes-Mandelieu Airport
LFMH	Saint-Ã‰tienne-BouthÃ©on Airport
LFMI	Istres Le TubÃ©/Istres Air Base (BA 125) Airport
LFMK	Carcassonne Airport
LFML	Marseille Provence Airport
LFMN	Nice-CÃ´te d'Azur Airport
LFMO	Orange-Caritat (BA 115) Air Base
LFMP	Perpignan-Rivesaltes (LlabanÃ¨re) Airport
LFMQ	Le Castellet Airport
LFMS	AlÃ¨s-Deaux Airport
LFMT	Montpellier-MÃ©diterranÃ©e Airport
LFMU	BÃ©ziers-Vias Airport
LFMV	Avignon-Caumont Airport
LFMY	Salon-de-Provence (BA 701) Air Base
LFNB	Mende-Brenoux Airfield
LFOA	Avord (BA 702) Air Base
LFOB	Paris Beauvais TillÃ© Airport
LFOC	ChÃ¢teaudun (BA 279) Air Base
LFOD	Saumur-Saint-Florent Airport
LFOE	Ã‰vreux-Fauville (BA 105) Air Base
LFOH	Le Havre Octeville Airport
LFOI	Abbeville
LFOJ	OrlÃ©ans-Bricy (BA 123) Air Base
LFOK	ChÃ¢lons-Vatry Airport
LFOP	Rouen Airport
LFOQ	Blois-Le Breuil Airport
LFOT	Tours-Val-de-Loire Airport
LFOU	Cholet Le Pontreau Airport
LFOV	Laval-Entrammes Airport
LFPB	Paris-Le Bourget Airport
LFPC	Creil Air Base
LFPG	Charles de Gaulle International Airport
LFPM	Melun-Villaroche Air Base
LFPN	Toussus-le-Noble Airport
LFPO	Paris-Orly Airport
LFPT	Pontoise - Cormeilles-en-Vexin Airport
LFPV	Villacoublay-VÃ©lizy (BA 107) Air Base
LFQB	Troyes-Barberey Airport
LFQE	Ã‰tain-Rouvres Air Base
LFQG	Nevers-Fourchambault Airport
LFQJ	Maubeuge-Ã‰lesmes Airport
LFQP	Phalsbourg-Bourscheid Air Base
LFQQ	Lille-Lesquin Airport
LFQT	Merville-Calonne Airport
LFQV	Charleville-MÃ©ziÃ¨res Airport
LFQW	Vesoul-Frotey Airport
LFRB	Brest Bretagne Airport
LFRC	Cherbourg-Maupertus Airport
LFRD	Dinard-Pleurtuit-Saint-Malo Airport
LFRE	La Baule-Escoublac Airport
LFRF	Granville Airport
LFRG	Deauville-Saint-Gatien Airport
LFRH	Lorient South Brittany (Bretagne Sud) Airport
LFRI	La Roche-sur-Yon Airport
LFRJ	Landivisiau Air Base
LFRK	Caen-Carpiquet Airport
LFRL	LanvÃ©oc-Poulmic Air Base
LFRM	Le Mans-Arnage Airport
LFRN	Rennes-Saint-Jacques Airport
LFRO	Lannion-CÃ´te de Granit Airport
LFRQ	Quimper-Cornouaille Airport
LFRS	Nantes Atlantique Airport
LFRT	Saint-Brieuc-Armor Airport
LFRU	Morlaix-Ploujean Airport
LFRV	Vannes-Meucon Airport
LFRZ	Saint-Nazaire-Montoir Airport
LFSB	EuroAirport Basel-Mulhouse-Freiburg Airport
LFSD	Dijon-Bourgogne Airport
LFSG	Ã‰pinal-Mirecourt Airport
LFSI	Saint-Dizier-Robinson (BA 113) Air Base
LFSM	MontbÃ©liard-Courcelles Airfield
LFSN	Nancy-Essey Airport
LFSO	Nancy-Ochey (BA 133) Air Base
LFST	Strasbourg Airport
LFSX	Luxeuil-Saint-Sauveur (BA 116) Air Base
LFTH	Toulon-HyÃ¨res Airport
LFTW	NÃ®mes-Arles-Camargue Airport
LFVM	Miquelon Airport
LFVP	St Pierre Airport
LFXA	AmbÃ©rieu Air Base (BA 278)
LGAD	Andravida Air Base
LGAL	Dimokritos Airport
LGAV	Eleftherios Venizelos International Airport
LGBL	Nea Anchialos Airport
LGEL	Elefsis Airport
LGHI	Chios Island National Airport
LGIO	Ioannina Airport
LGIR	Heraklion International Nikos Kazantzakis Airport
LGKF	Kefallinia Airport
LGKL	Kalamata Airport
LGKO	Kos Airport
LGKP	Karpathos Airport
LGKR	Ioannis Kapodistrias International Airport
LGKV	Alexander the Great International Airport
LGKZ	Filippos Airport
LGMK	Mikonos Airport
LGMT	Mytilene International Airport
LGPZ	Aktion National Airport
LGRP	Diagoras Airport
LGRX	Araxos Airport
LGSA	Chania International Airport
LGSK	Skiathos Island National Airport
LGSM	Samos Airport
LGSR	Santorini Airport
LGST	Sitia Airport
LGTG	Tanagra Air Base
LGTS	Thessaloniki Macedonia International Airport
LGZA	Zakynthos International Airport "Dionysios Solomos"
LHBP	Budapest Liszt Ferenc International Airport
LHDC	Debrecen International Airport
LHKE	KecskemÃ©t Airport
LHPP	PÃ©cs-PogÃ¡ny Airport
LHPR	GyÅ‘r-PÃ©r International Airport
LHSM	SÃ¡rmellÃ©k International Airport
LHSN	Szolnok Air Base
LHTA	TaszÃ¡r Air Base
LHTL	TÃ¶kÃ¶l Airport
LIBA	Amendola Air Base
LIBC	Crotone Airport
LIBD	Bari Karol WojtyÅ‚a Airport
LIBF	Foggia "Gino Lisa" Airport
LIBG	Taranto-Grottaglie "Marcello Arlotta" Airport
LIBN	Lecce Galatina Air Base
LIBP	Pescara International Airport
LIBR	Brindisi â€“ Salento Airport
LIBV	Gioia Del Colle Air Base
LICA	Lamezia Terme Airport
LICB	Comiso Airport
LICC	Catania-Fontanarossa Airport
LICD	Lampedusa Airport
LICG	Pantelleria Airport
LICJ	Falconeâ€“Borsellino Airport
LICP	Palermo-Boccadifalco Airport
LICR	Reggio Calabria Airport
LICT	Vincenzo Florio Airport Trapani-Birgi
LICZ	Sigonella Navy Air Base
LIDT	Trento-Mattarello Airport
LIEA	Alghero-Fertilia Airport
LIED	Decimomannu Air Base
LIEE	Cagliari Elmas Airport
LIEO	Olbia Costa Smeralda Airport
LIET	TortolÃ¬ Airport
LILA	Alessandria Airport
LILE	Biella-Cerrione Airport
LILI	Vercelli Airport
LILM	Casale Monferrato Airport
LILN	Varese-Venegono Airport
LIMA	Torino-Aeritalia Airport
LIMC	Malpensa International Airport
LIME	Il Caravaggio International Airport
LIMF	Turin Airport
LIMG	Villanova D'Albenga International Airport
LIMJ	Genoa Cristoforo Colombo Airport
LIML	Milano Linate Airport
LIMN	Cameri Air Base [MIL]
LIMP	Parma Airport
LIMR	Novi Ligure Airport
LIMS	Piacenza San Damiano Air Base
LIMW	Aosta Airport
LIMZ	Cuneo International Airport
LIPA	Aviano Air Base
LIPB	Bolzano Airport
LIPC	Cervia Air Base
LIPE	Bologna Guglielmo Marconi Airport
LIPH	Treviso-Sant'Angelo Airport
LIPI	Rivolto Air Base
LIPK	ForlÃ¬ Airport
LIPL	Ghedi Air Base
LIPO	Brescia Airport
LIPQ	Triesteâ€“Friuli Venezia Giulia Airport
LIPR	Federico Fellini International Airport
LIPS	Istrana Air Base
LIPU	Padova Airport
LIPX	Verona Villafranca Airport
LIPY	Ancona Falconara Airport
LIPZ	Venice Marco Polo Airport
LIQS	Siena-Ampugnano Airport
LIQW	Sarzana-Luni Air Base
LIRA	Ciampinoâ€“G. B. Pastine International Airport
LIRE	Pratica Di Mare Air Base
LIRF	Leonardo da Vinciâ€“Fiumicino Airport
LIRG	Guidonia Air Base
LIRI	Salerno Costa d'Amalfi Airport
LIRJ	Marina Di Campo Airport
LIRL	Latina Air Base
LIRM	Grazzanise Air Base
LIRN	Naples International Airport
LIRP	Pisa International Airport
LIRQ	Peretola Airport
LIRS	Grosseto Air Base
LIRU	Urbe Airport
LIRV	Viterbo Airport
LIRZ	Perugia San Francesco d'Assisi â€“ Umbria International Airport
LJCE	Cerklje Airport
LJLJ	Ljubljana JoÅ¾e PuÄnik Airport
LJMB	Maribor Airport
LJPZ	Portoroz Airport
LKCV	ÄŒÃ¡slav Air Base
LKKB	Kbely Air Base
LKKU	Kunovice Airport
LKKV	Karlovy Vary International Airport
LKLN	PlzeÅˆ-LÃ­nÄ› Airport
LKMT	Ostrava Leos JanÃ¡Äek Airport
LKNA	NÃ¡mÄ›Å¡Å¥ Air Base
LKPD	Pardubice Airport
LKPO	PÅ™erov Air Base
LKPR	VÃ¡clav Havel Airport Prague
LKTB	Brno-TuÅ™any Airport
LKVO	Vodochody Airport
LLBG	Ben Gurion International Airport
LLEK	Tel Nof Air Base
LLER	Ramon Airport
LLHA	Haifa International Airport
LLIB	Ben Ya'akov Airport
LLMZ	Bar Yehuda Airfield
LLNV	Nevatim Air Base
LLOV	Ovda International Airport
LLRD	Ramat David Air Base
LLRM	Ramon Air Base
LLSD	Sde Dov Airport
LMML	Malta International Airport
LOAN	Wiener Neustadt East Airport
LOWG	Graz Airport
LOWI	Innsbruck Airport
LOWK	Klagenfurt Airport
LOWL	Linz HÃ¶rsching Airport
LOWS	Salzburg Airport
LOWW	Vienna International Airport
LOXZ	Hinterstoisser Air Base
LPAR	Alverca Air Base
LPAZ	Santa Maria Airport
LPBG	BraganÃ§a Airport
LPBJ	Beja Airport / Airbase
LPBR	Braga Municipal Aerodrome
LPCB	Aerodromo de Castelo Branco
LPCO	Aerodromo Municipal de Coimbra
LPCS	Cascais Airport
LPEV	Ã‰vora Airport
LPFL	Flores Airport
LPFR	Faro Airport
LPGR	Graciosa Airport
LPHR	Horta Airport
LPLA	Lajes Airport
LPMA	Madeira Airport
LPMR	Monte Real Air Base
LPMT	Montijo Air Base
LPOT	Ota Air Base
LPOV	Ovar Air Base
LPPD	JoÃ£o Paulo II Airport
LPPI	Pico Airport
LPPM	PortimÃ£o Airport
LPPR	Francisco de SÃ¡ Carneiro Airport
LPPS	Porto Santo Airport
LPPT	Humberto Delgado Airport (Lisbon Portela Airport)
LPSJ	SÃ£o Jorge Airport
LPSO	Ponte de Sor Airport
LPST	Sintra Air Base
LPTN	Tancos Airbase
LPVL	Vilar de Luz Airfield
LPVR	Vila Real Airport
LPVZ	Aerodromo Goncalves Lobato (Viseu Airport)
LQBK	Banja Luka International Airport
LQMO	Mostar International Airport
LQSA	Sarajevo International Airport
LQTZ	Tuzla International Airport
LR79	Ianca Air Base
LR80	FeteÅŸti Air Base
LR82	Boboc Air Base
LRAR	Arad International Airport
LRBC	BacÄƒu Airport
LRBM	MaramureÈ™ International Airport
LRBS	BÄƒneasa International Airport
LRCK	Mihail KogÄƒlniceanu International Airport
LRCL	Cluj-Napoca International Airport
LRCS	CaransebeÅŸ Airport
LRCT	CÃ¢mpia Turzii Air Base
LRCV	Craiova Airport
LRIA	IaÅŸi Airport
LROD	Oradea International Airport
LROP	Henri CoandÄƒ International Airport
LRSB	Sibiu International Airport
LRSM	Satu Mare Airport
LRSV	Suceava Stefan cel Mare Airport
LRTC	Tulcea Airport
LRTM	Transilvania TÃ¢rgu MureÅŸ International Airport
LRTR	TimiÅŸoara Traian Vuia Airport
LSGC	Les Eplatures Airport
LSGG	Geneva Cointrin International Airport
LSGS	Sion Airport
LSMA	Alpnach Air Base
LSMD	DÃ¼bendorf Air Base
LSME	Emmen Air Base
LSMF	Mollis Airport
LSMP	Payerne Air Base
LSZA	Lugano Airport
LSZB	Bern Belp Airport
LSZG	Grenchen Airport
LSZH	ZÃ¼rich Airport
LSZR	St Gallen Altenrhein Airport
LSZS	Samedan Airport
LTAC	EsenboÄŸa International Airport
LTAD	Etimesgut Air Base
LTAE	AkÄ±ncÄ± Air Base
LTAF	Adana Airport
LTAG	Ä°ncirlik Air Base
LTAH	Afyon Airport
LTAI	Antalya International Airport
LTAJ	Gaziantep International Airport
LTAN	Konya Airport
LTAT	Malatya ErhaÃ§ Airport
LTAU	Kayseri Erkilet Airport
LTAV	Sivrihisar Airport
LTAW	Tokat Airport
LTAY	Ã‡ardak Airport
LTBA	AtatÃ¼rk International Airport
LTBF	BalÄ±kesir Merkez Airport
LTBG	BandÄ±rma Airport
LTBH	Ã‡anakkale Airport
LTBI	EskiÅŸehir Air Base
LTBJ	Adnan Menderes International Airport
LTBL	Ã‡iÄŸli Airport
LTBQ	Cengiz Topel Airport
LTBR	Bursa YeniÅŸehir Airport
LTBS	Dalaman International Airport
LTBT	Akhisar Airport
LTBU	TekirdaÄŸ Ã‡orlu Airport
LTBX	SamandÄ±ra Air Base
LTBY	Anadolu Airport
LTCA	ElazÄ±ÄŸ Airport
LTCC	Diyarbakir Airport
LTCD	Erzincan Airport
LTCE	Erzurum International Airport
LTCF	Kars Airport
LTCG	Trabzon International Airport
LTCH	ÅžanlÄ±urfa Airport
LTCI	Van Ferit Melen Airport
LTCJ	Batman Airport
LTCK	MuÅŸ Airport
LTCL	Siirt Airport
LTCN	KahramanmaraÅŸ Airport
LTCO	AÄŸrÄ± Airport
LTCP	AdÄ±yaman Airport
LTCR	Mardin Airport
LTCS	ÅžanlÄ±urfa GAP Airport
LTCV	ÅžÄ±rnak Åžerafettin ElÃ§i Airport
LTCW	Hakkari YÃ¼ksekova Airport
LTDA	Hatay Airport
LTFC	SÃ¼leyman Demirel International Airport
LTFD	BalÄ±kesir KÃ¶rfez Airport
LTFE	Milas Bodrum International Airport
LTFJ	Sabiha GÃ¶kÃ§en International Airport
LTGP	GazipaÅŸa Airport
LUBL	BÄƒlÈ›i International Airport
LUBM	MÄƒrculeÅŸti International Airport
LUCH	Cahul International Airport
LUKK	ChiÅŸinÄƒu International Airport
LUTR	Tiraspol Airport
LUZ	Lublin Airport
LWOH	Ohrid St. Paul the Apostle Airport
LWSK	Skopje Alexander the Great Airport
LXGB	Gibraltar Airport
LY-BCQ	Brak Airport
LYBE	Belgrade Nikola Tesla Airport
LYBT	Batajnica Air Base
LYNI	Nis Airport
LYPG	Podgorica Airport
LYTV	Tivat Airport
LZIB	M. R. Å tefÃ¡nik Airport
LZKZ	KoÅ¡ice Airport
LZMC	KuchyÅˆa Air Base
LZPP	PieÅ¡Å¥any Airport
LZSL	SliaÄ Airport
LZTN	TrenÄÃ­n Airport
LZTT	Poprad-Tatry Airport
LZZI	Å½ilina Airport
MBGT	JAGS McCartney International Airport
MBNC	North Caicos Airport
MBPV	Providenciales Airport
MBSC	South Caicos Airport
MDBH	Maria Montez International Airport
MDCR	Cabo Rojo Airport
MDCY	SamanÃ¡ El Catey International Airport
MDJB	La Isabela International Airport
MDLR	Casa De Campo International Airport
MDPC	Punta Cana International Airport
MDPP	Gregorio Luperon International Airport
MDSD	Las AmÃ©ricas International Airport
MDSI	San Isidro Air Base
MDST	Cibao International Airport
MGCB	Coban Airport
MGGT	La Aurora Airport
MGPB	Puerto Barrios Airport
MGRB	Rubelsanto Airport
MGRT	Retalhuleu Airport
MGSJ	San JosÃ© Airport
MGTK	Mundo Maya International Airport
MHLC	Goloson International Airport
MHLM	RamÃ³n Villeda Morales International Airport
MHNJ	La Laguna Airport
MHRO	Juan Manuel Galvez International Airport
MHSC	Coronel Enrique Soto Cano Air Base
MHTE	Tela Airport
MHTG	ToncontÃ­n International Airport
MHTJ	Trujillo Airport
MKBS	Boscobel Aerodrome
MKJP	Norman Manley International Airport
MKJS	Sangster International Airport
MKKJ	Ken Jones Airport
MKTP	Tinson Pen Airport
MMAA	General Juan N Alvarez International Airport
MMAN	Del Norte International Airport
MMAS	JesÃºs TerÃ¡n Paredo International Airport
MMBT	BahÃ­as de Huatulco International Airport
MMCB	General Mariano Matamoros Airport
MMCE	Ciudad del Carmen International Airport
MMCL	Bachigualato Federal International Airport
MMCM	Chetumal International Airport
MMCN	Ciudad ObregÃ³n International Airport
MMCP	Ingeniero Alberto AcuÃ±a Ongay International Airport
MMCS	Abraham GonzÃ¡lez International Airport
MMCT	Chichen Itza International Airport
MMCU	General Roberto Fierro Villalobos International Airport
MMCV	General Pedro Jose Mendez International Airport
MMCY	Captain Rogelio Castillo National Airport
MMCZ	Cozumel International Airport
MMDA	Ciudad ConstituciÃ³n Airport
MMDO	General Guadalupe Victoria International Airport
MMEP	Amado Nervo National Airport
MMGL	Don Miguel Hidalgo Y Costilla International Airport
MMGM	General JosÃ© MarÃ­a YÃ¡Ã±ez International Airport
MMHO	General Ignacio P. Garcia International Airport
MMIA	Licenciado Miguel de la Madrid Airport
MMIO	Plan De Guadalupe International Airport
MMIT	Ixtepec Airport
MMJA	El Lencero Airport
MMLC	LÃ¡zaro CÃ¡rdenas Airport
MMLM	Valle del Fuerte International Airport
MMLO	Del BajÃ­o International Airport
MMLP	Manuel MÃ¡rquez de LeÃ³n International Airport
MMLT	Loreto International Airport
MMMA	General Servando Canales International Airport
MMMD	Licenciado Manuel Crescencio Rejon Int Airport
MMML	General Rodolfo SÃ¡nchez Taboada International Airport
MMMM	General Francisco J. Mujica International Airport
MMMT	MinatitlÃ¡n/Coatzacoalcos National Airport
MMMV	Monclova International Airport
MMMX	Licenciado Benito Juarez International Airport
MMMY	General Mariano Escobedo International Airport
MMMZ	General Rafael Buelna International Airport
MMNL	QuetzalcÃ³atl International Airport
MMOX	XoxocotlÃ¡n International Airport
MMPA	El TajÃ­n National Airport
MMPB	Hermanos SerdÃ¡n International Airport
MMPG	Piedras Negras International Airport
MMPN	Licenciado y General Ignacio Lopez Rayon Airport
MMPR	Licenciado Gustavo DÃ­az Ordaz International Airport
MMPS	Puerto Escondido International Airport
MMQT	QuerÃ©taro Intercontinental Airport
MMRX	General Lucio Blanco International Airport
MMSD	Los Cabos International Airport
MMSL	Cabo San Lucas International Airport
MMSP	Ponciano Arriaga International Airport
MMTB	TerÃ¡n Air Base
MMTC	Francisco Sarabia International Airport
MMTG	Angel Albino Corzo International Airport
MMTJ	General Abelardo L. RodrÃ­guez International Airport
MMTM	General Francisco Javier Mina International Airport
MMTO	Licenciado Adolfo Lopez Mateos International Airport
MMTP	Tapachula International Airport
MMUN	CancÃºn International Airport
MMVA	Carlos Rovirosa PÃ©rez International Airport
MMVR	General Heriberto Jara International Airport
MMZC	General Leobardo C. Ruiz International Airport
MMZH	Ixtapa Zihuatanejo International Airport
MMZO	Playa De Oro International Airport
MNBL	Bluefields Airport
MNMG	Augusto C. Sandino (Managua) International Airport
MNPC	Puerto Cabezas Airport
MPBO	Bocas Del Toro International Airport
MPCE	Alonso Valderrama Airport
MPCH	Cap Manuel NiÃ±o International Airport
MPDA	Enrique Malek International Airport
MPEJ	Enrique Adolfo Jimenez Airport
MPMG	Marcos A. Gelabert International Airport
MPSA	Ruben Cantu Airport
MPTO	Tocumen International Airport
MRAO	Aerotortuguero Airport
MRBA	Buenos Aires Airport
MRBC	Barra del Colorado Airport
MRCC	Coto 47 Airport
MRGF	Golfito Airport
MRGP	Guapiles Airport
MRLB	Daniel Oduber Quiros International Airport
MRLC	Los Chiles Airport
MRLM	Limon International Airport
MRNS	Nosara Airport
MROC	Juan Santamaria International Airport
MRPJ	Puerto Jimenez Airport
MRPM	Palmar Sur Airport
MRPV	Tobias Bolanos International Airport
MRQP	Quepos Managua Airport
MRSV	San Vito De Java Airport
MRUP	Upala Airport
MSLP	MonseÃ±or Ã“scar Arnulfo Romero International Airport
MSSS	Ilopango International Airport
MTCA	Les Cayes Airport
MTCH	Cap Haitien International Airport
MTJA	Jacmel Airport
MTJE	JÃ©rÃ©mie Airport
MTPP	Toussaint Louverture International Airport
MTPX	Port-de-Paix Airport
MUBA	Gustavo Rizo Airport
MUBY	Carlos Manuel de Cespedes Airport
MUCA	Maximo Gomez Airport
MUCC	Jardines Del Rey Airport
MUCF	Jaime Gonzalez Airport
MUCL	Vilo AcuÃ±a International Airport
MUCM	Ignacio Agramonte International Airport
MUCU	Antonio Maceo International Airport
MUGM	Leeward Point Field
MUGT	Mariana Grajales Airport
MUHA	JosÃ© MartÃ­ International Airport
MUHG	Frank Pais International Airport
MUKW	Kawama Airport
MULM	La Coloma Airport
MUMO	Orestes Acosta Airport
MUMZ	Sierra Maestra Airport
MUNB	San Nicolas De Bari Airport
MUNG	Rafael Cabrera Airport
MUPB	Playa Baracoa Airport
MUPR	Pinar Del Rio Airport
MUSC	Abel Santamaria Airport
MUSJ	San Julian Air Base
MUSN	Siguanea Airport
MUTD	Alberto Delgado Airport
MUVR	Juan Gualberto Gomez International Airport
MUVT	Hermanos Ameijeiras Airport
MWCB	Gerrard Smith International Airport
MWCL	Edward Bodden Airfield
MWCR	Owen Roberts International Airport
MYAB	Clarence A. Bain Airport
MYAF	Andros Town Airport
MYAK	Congo Town Airport
MYAM	Leonard M Thompson International Airport
MYAN	San Andros Airport
MYAP	Spring Point Airport
MYAT	Treasure Cay Airport
MYBC	Chub Cay Airport
MYBG	Great Harbour Cay Airport
MYBS	South Bimini Airport
MYCA	Arthur's Town Airport
MYCB	New Bight Airport
MYCI	Colonel Hill Airport
MYEF	Exuma International Airport
MYEG	George Town Airport
MYEH	North Eleuthera Airport
MYEM	Governor's Harbour Airport
MYEN	Normans Cay Airport
MYER	Rock Sound Airport
MYES	Staniel Cay Airport
MYGF	Grand Bahama International Airport
MYIG	Inagua Airport
MYLD	Deadman's Cay Airport
MYLR	Hard Bargain Airport
MYLS	Stella Maris Airport
MYMM	Mayaguana Airport
MYNN	Lynden Pindling International Airport
MYRD	Duncan Town Airport
MYSM	San Salvador Airport
MZBZ	Philip S. W. Goldson International Airport
NBS	Changbaishan Airport
NCRG	Rarotonga International Airport
NFFN	Nadi International Airport
NFNA	Nausori International Airport
NFNL	Labasa Airport
NFTF	Fua'amotu International Airport
NFTL	Lifuka Island Airport
NFTV	Vava'u International Airport
NG-0003	Gombe Lawanti International Airport
NG-QRW	Warri Airport
NGFU	Funafuti International Airport
NGTA	Bonriki International Airport
NGTE	Tabiteuea North Airport
NIUE	Niue International Airport
NLH	Ninglang Luguhu Airport
NLWF	Pointe Vele Airport
NLWW	Hihifo Airport
NSFA	Faleolo International Airport
NSFQ	Fitiuta Airport
NSTU	Pago Pago International Airport
NTAA	Faa'a International Airport
NTAR	Rurutu Airport
NTAT	Tubuai Airport
NTGA	Anaa Airport
NTGB	Fangatau Airport
NTGC	Tikehau Airport
NTGE	Reao Airport
NTGF	Fakarava Airport
NTGI	Manihi Airport
NTGJ	Totegegie Airport
NTGK	Kaukura Airport
NTGM	Makemo Airport
NTGP	Puka Puka Airport
NTGT	Takapoto Airport
NTGU	Arutua Airport
NTGV	Mataiva Airport
NTHE	Ahe Airport
NTKR	Takaroa Airport
NTMD	Nuku Hiva Airport
NTMN	Hiva Oa-Atuona Airport
NTTB	Bora Bora Airport
NTTG	Rangiroa Airport
NTTH	Huahine-Fare Airport
NTTM	Moorea Airport
NTTO	Hao Airport
NTTP	Maupiti Airport
NTTR	Raiatea Airport
NVSQ	Gaua Island Airport
NVSS	Santo Pekoa International Airport
NVVV	Bauerfield International Airport
NVVW	Tanna Airport
NWWA	Tiga Airport
NWWC	ÃŽle Art - Waala Airport
NWWD	KonÃ© Airport
NWWE	ÃŽle des Pins Airport
NWWK	Koumac Airport
NWWL	Lifou Airport
NWWM	NoumÃ©a Magenta Airport
NWWR	MarÃ© Airport
NWWU	Touho Airport
NWWV	OuvÃ©a Airport
NWWW	La Tontouta International Airport
NZAA	Auckland International Airport
NZAP	Taupo Airport
NZAR	Ardmore Airport
NZCH	Christchurch International Airport
NZCI	Chatham Islands-Tuuta Airport
NZDN	Dunedin Airport
NZGS	Gisborne Airport
NZGT	Glentanner Airport
NZHK	Hokitika Airfield
NZHN	Hamilton International Airport
NZIR	McMurdo Station Ice Runway
NZKK	Kerikeri Airport
NZKT	Kaitaia Airport
NZLX	Alexandra Airport
NZMC	Mount Cook Airport
NZMO	Manapouri Airport
NZMS	Hood Airport
NZNP	New Plymouth Airport
NZNR	Hawke's Bay Airport
NZNS	Nelson Airport
NZNV	Invercargill Airport
NZOH	RNZAF Base Ohakea
NZOU	Oamaru Airport
NZPG	McMurdo Station Pegasus Field
NZPM	Palmerston North Airport
NZPP	Paraparaumu Airport
NZQN	Queenstown International Airport
NZRO	Rotorua Regional Airport
NZSP	South Pole Station Airport
NZTG	Tauranga Airport
NZTU	Timaru Airport
NZUK	Pukaki Airport
NZWB	Woodbourne Airport
NZWD	Williams Field
NZWF	Wanaka Airport
NZWK	Whakatane Airport
NZWN	Wellington International Airport
NZWO	Wairoa Airport
NZWP	RNZAF Base Auckland-Whenuapai
NZWR	Whangarei Airport
NZWS	Westport Airport
NZWU	Wanganui Airport
OAHR	Herat Airport
OAIX	Bagram Air Base
OAJL	Jalalabad Airport
OAKB	Hamid Karzai International Airport
OAKN	Kandahar Airport
OAMN	Maimana Airport
OAMS	Mazar I Sharif Airport
OAUZ	Konduz Airport
OBBI	Bahrain International Airport
OBBS	Sheik Isa Air Base
OEAB	Abha Regional Airport
OEAH	Al Ahsa Airport
OEBA	Al Baha Airport
OEBH	Bisha Airport
OEDF	King Fahd International Airport
OEDM	King Salman Abdulaziz Airport
OEDR	King Abdulaziz Air Base
OEGN	Jizan Regional Airport
OEGS	Gassim Airport
OEGT	Gurayat Domestic Airport
OEHL	Ha'il Airport
OEJB	Jubail Airport
OEJF	King Faisal Naval Base
OEJN	King Abdulaziz International Airport
OEKK	King Khaled Military City Airport
OEKM	King Khaled Air Base
OEMA	Prince Mohammad Bin Abdulaziz Airport
OENG	Nejran Airport
OEPA	Al Qaisumah/Hafr Al Batin Airport
OEPS	Prince Sultan Air Base
OERF	Rafha Domestic Airport
OERK	King Khaled International Airport
OERM	Ras Mishab Airport
OERR	Arar Domestic Airport
OERT	Ras Tanura Airport
OERY	Riyadh Air Base
OESH	Sharurah Airport
OESK	Al-Jawf Domestic Airport
OETB	Tabuk Airport
OETF	Taâ€™if Regional Airport
OETN	Ras Tanajib Airport
OETR	Turaif Domestic Airport
OEWD	Wadi Al Dawasir Airport
OEWJ	Al Wajh Domestic Airport
OEYN	Prince Abdulmohsin Bin Abdulaziz Airport
OIAA	Abadan Airport
OIAG	Aghajari Airport
OIAH	Gachsaran Airport
OIAI	Shahid Asyaee Airport
OIAM	Mahshahr Airport
OIAW	Ahwaz Airport
OIBA	Abu Musa Island Airport
OIBB	Bushehr Airport
OIBJ	Jam Airport
OIBK	Kish International Airport
OIBL	Bandar Lengeh Airport
OIBP	Persian Gulf International Airport
OIBQ	Khark Island Airport
OIBS	Sirri Island Airport
OIBV	Lavan Island Airport
OICC	Shahid Ashrafi Esfahani Airport
OICI	Ilam Airport
OICK	Khoram Abad Airport
OICS	Sanandaj Airport
OIFK	Kashan Airport
OIFM	Esfahan Shahid Beheshti International Airport
OIFP	Badr Air Base
OIFS	Shahrekord Airport
OIGG	Sardar-e-Jangal Airport
OIHH	Hamadan Airport
OIHS	Hamadan Air Base
OIIE	Imam Khomeini International Airport
OIIG	Ghale Morghi Airport
OIII	Mehrabad International Airport
OIIK	Qazvin Airport
OIIM	Naja Airport
OIIP	Payam International Airport
OIKB	Bandar Abbas International Airport
OIKJ	Jiroft Airport
OIKK	Kerman Airport
OIKM	Bam Airport
OIKQ	Dayrestan Airport
OIKR	Rafsanjan Airport
OIKY	Sirjan Airport
OIMB	Birjand Airport
OIMC	Sarakhs Airport
OIMM	Mashhad International Airport
OIMN	Bojnord Airport
OIMS	Sabzevar National Airport
OIMT	Tabas Airport
OING	Gorgan Airport
OINN	Noshahr Airport
OINR	Ramsar Airport
OINZ	Dasht-e Naz Airport
OISF	Fasa Airport
OISL	Lar Airport
OISS	Shiraz Shahid Dastghaib International Airport
OISY	Yasouj Airport
OITL	Ardabil Airport
OITR	Urmia Airport
OITT	Tabriz International Airport
OITZ	Zanjan Airport
OIYY	Shahid Sadooghi Airport
OIZB	Zabol Airport
OIZC	Konarak Airport
OIZH	Zahedan International Airport
OIZI	Iran Shahr Airport
OJ40	Muwaffaq Salti Air Base
OJAI	Queen Alia International Airport
OJAM	Amman-Marka International Airport
OJAQ	Aqaba King Hussein International Airport
OKAJ	Ahmed Al Jaber Air Base
OKAS	Ali Al Salem Air Base
OKBK	Kuwait International Airport
OLBA	Beirut Rafic Hariri International Airport
OLKA	Rene Mouawad Air Base
OLRA	Rayak Air Base
OM-0003	Duqm International Airport
OM-0004	Rustaq Airport
OMAA	Abu Dhabi International Airport
OMAD	Bateen Airport
OMAL	Al Ain International Airport
OMAM	Al Dhafra Air Base
OMBY	Sir Bani Yas Airport
OMDB	Dubai International Airport
OMDM	Al Minhad Air Base
OMDW	Al Maktoum International Airport
OMFJ	Fujairah International Airport
OMRK	Ras Al Khaimah International Airport
OMSJ	Sharjah International Airport
OOKB	Khasab Air Base
OOMA	Masirah Air Base
OOMS	Muscat International Airport
OOSA	Salalah Airport
OOTH	Thumrait Air Base
OP12	Bandari Air Base
OPBW	Bahawalpur Airport
OPCH	Chitral Airport
OPDG	Dera Ghazi Khan Airport
OPDI	Dera Ismael Khan Airport
OPFA	Faisalabad International Airport
OPGD	Gwadar International Airport
OPGT	Gilgit Airport
OPJA	Shahbaz Air Base
OPKC	Jinnah International Airport
OPLA	Alama Iqbal International Airport
OPLH	Walton Airport
OPMA	Mangla Airport
OPMF	Muzaffarabad Airport
OPMI	Mianwali Air Base
OPMJ	Moenjodaro Airport
OPMR	Masroor Air Base
OPMS	Minhas Air Base
OPMT	Multan International Airport
OPNH	Shaheed Benazirabad Airport
OPPG	Panjgur Airport
OPPI	Pasni Airport
OPPS	Peshawar International Airport
OPQT	Quetta International Airport
OPRK	Shaikh Zaid Airport
OPRN	Benazir Bhutto International Airport
OPRQ	Rafiqui Air Base
OPRS	Risalpur Air Base
OPRT	Rawalakot Airport
OPSD	Skardu Airport
OPSF	Faisal Air Base
OPSK	Sukkur Airport
OPSN	Sehwan Sharif Airport
OPSR	Mushaf Air Base
OPSS	Saidu Sharif Airport
OPST	Sialkot Airport
OPSU	Sui Airport
OPTU	Turbat International Airport
OPZB	Zhob Airport
ORAA	Al Asad Air Base
ORAT	Al Taqaddum Air Base
ORBD	Joint Base Balad
ORBI	Baghdad International Airport
ORBM	Mosul International Airport
ORER	Erbil International Airport
ORKK	Kirkuk Air Base
ORMM	Basrah International Airport
ORQW	Qayyarah West Airport
ORSH	Al Sahra Army Air Field
ORSU	Sulaymaniyah International Airport
ORTF	Tall Afar Army Air Field
ORTI	Al Taji Army Air Field
ORTL	Ali Air Base
ORUB	Ubaydah Bin Al Jarrah Airport
OS57	Abu ad Duhur Air Base
OS64	An Nasiriyah Air Base
OS69	Khalkhalah Air Base
OS70	Al Qusayr Air Base
OSAP	Aleppo International Airport
OSDI	Damascus International Airport
OSDZ	Deir ez-Zor Air Base
OSKL	Kamishly Airport
OSLK	Bassel Al-Assad International Airport
OSPR	Palmyra Airport
OTBD	Doha International Airport
OTBH	Al Udeid Air Base
OY74	Al Anad Air Base
OYAA	Aden International Airport
OYAT	Ataq Airport
OYBN	Beihan Airport
OYGD	Al Ghaidah International Airport
OYHD	Hodeidah International Airport
OYRN	Mukalla International Airport
OYSN	Sana'a International Airport
OYSQ	Socotra International Airport
OYSY	Sayun International Airport
OYTZ	Ta'izz International Airport
PAAQ	Warren "Bud" Woods Palmer Municipal Airport
PABA	Barter Island LRRS Airport
PABE	Bethel Airport
PABI	Allen Army Airfield
PABL	Buckland Airport
PABR	Wiley Post Will Rogers Memorial Airport
PABT	Bettles Airport
PABV	Birchwood Airport
PACD	Cold Bay Airport
PACL	Clear Airport
PACM	Scammon Bay Airport
PACV	Merle K (Mudhole) Smith Airport
PACZ	Cape Romanzof LRRS Airport
PADE	Deering Airport
PADK	Adak Airport
PADL	Dillingham Airport
PADM	Marshall Don Hunter Sr Airport
PADQ	Kodiak Airport
PADU	Unalaska Airport
PAED	Elmendorf Air Force Base
PAEH	Cape Newenham LRRS Airport
PAEI	Eielson Air Force Base
PAEM	Emmonak Airport
PAEN	Kenai Municipal Airport
PAFA	Fairbanks International Airport
PAFB	Ladd AAF Airfield
PAFE	Kake Airport
PAFM	Ambler Airport
PAGA	Edward G. Pitka Sr Airport
PAGK	Gulkana Airport
PAGM	Gambell Airport
PAGS	Gustavus Airport
PAHC	Holy Cross Airport
PAHL	Huslia Airport
PAHN	Haines Airport
PAHO	Homer Airport
PAHP	Hooper Bay Airport
PAII	Egegik Airport
PAIK	Bob Baker Memorial Airport
PAIL	Iliamna Airport
PAIM	Indian Mountain LRRS Airport
PAJN	Juneau International Airport
PAKN	King Salmon Airport
PAKP	Anaktuvuk Pass Airport
PAKT	Ketchikan International Airport
PAKW	Klawock Airport
PALU	Cape Lisburne LRRS Airport
PAMC	McGrath Airport
PAMR	Merrill Field
PAMY	Mekoryuk Airport
PANC	Ted Stevens Anchorage International Airport
PANI	Aniak Airport
PANN	Nenana Municipal Airport
PANT	Annette Island Airport
PANV	Anvik Airport
PAOM	Nome Airport
PAOR	Northway Airport
PAOT	Ralph Wien Memorial Airport
PAPB	St George Airport
PAPC	Port Clarence Coast Guard Station
PAPG	Petersburg James A Johnson Airport
PAPH	Port Heiden Airport
PAPM	Platinum Airport
PAQT	Nuiqsut Airport
PARC	Arctic Village Airport
PARY	Ruby Airport
PASA	Savoonga Airport
PASC	Deadhorse Airport
PASD	Sand Point Airport
PASH	Shishmaref Airport
PASI	Sitka Rocky Gutierrez Airport
PASK	Selawik Airport
PASM	St Mary's Airport
PASN	St Paul Island Airport
PASV	Sparrevohn LRRS Airport
PASX	Soldotna Airport
PASY	Eareckson Air Station
PATG	Togiak Airport
PATK	Talkeetna Airport
PATL	Tatalina LRRS Airport
PATQ	Atqasuk Edward Burnell Sr Memorial Airport
PAVD	Valdez Pioneer Field
PAVL	Kivalina Airport
PAWD	Seward Airport
PAWG	Wrangell Airport
PAWI	Wainwright Airport
PAWN	Noatak Airport
PAWS	Wasilla Airport
PAYA	Yakutat Airport
PCIS	Canton Island Airport
PFYU	Fort Yukon Airport
PG-OPU	Balimo Airport
PG-VMU	Baimuru Airport
PGRO	Rota International Airport
PGSN	Saipan International Airport
PGUA	Andersen Air Force Base
PGUM	Antonio B. Won Pat International Airport
PGWT	Tinian International Airport
PH-0001	Laguindingan Airport
PH-0073	Northern Cagayan International Airport
PHBK	Barking Sands Airport
PHDH	Dillingham Airfield
PHHI	Wheeler Army Airfield
PHHN	Hana Airport
PHJH	Kapalua Airport
PHJR	Kalaeloa Airport
PHKO	Ellison Onizuka Kona International At Keahole Airport
PHLI	Lihue Airport
PHMK	Molokai Airport
PHMU	Waimea Kohala Airport
PHNG	Kaneohe Bay MCAS (Marion E. Carl Field) Airport
PHNL	Daniel K Inouye International Airport
PHNY	Lanai Airport
PHOG	Kahului Airport
PHSF	Bradshaw Army Airfield
PHTO	Hilo International Airport
PHUP	Upolu Airport
PK-0001	New Islamabad International Airport
PKMJ	Marshall Islands International Airport
PKSA	Kaieteur International Airport
PKWA	Bucholz Army Air Field
PLCH	Cassidy International Airport
PMDY	Henderson Field
PPIZ	Point Lay LRRS Airport
PTKK	Chuuk International Airport
PTPN	Pohnpei International Airport
PTRO	Babelthuap Airport
PTSA	Kosrae International Airport
PTYA	Yap International Airport
PWAK	Wake Island Airfield
QA-0001	Hamad International Airport
RCAY	Gangshan Air Force Base
RCBS	Kinmen Airport
RCDC	Pingtung South Airport
RCDI	Longtan Air Base
RCFG	Matsu Nangan Airport
RCFN	Taitung Airport
RCKH	Kaohsiung International Airport
RCKU	Chiayi Airport
RCKW	Hengchun Airport
RCLY	Lanyu Airport
RCMQ	Taichung Ching Chuang Kang Airport
RCMT	Matsu Beigan Airport
RCNN	Tainan Airport
RCPO	Hsinchu Air Base
RCQC	Makung Airport
RCQS	Chihhang Air Base
RCSQ	Pingtung North Airport
RCSS	Taipei Songshan Airport
RCTP	Taiwan Taoyuan International Airport
RCYU	Hualien Airport
RJAA	Narita International Airport
RJAF	Matsumoto Airport
RJAH	Hyakuri Airport
RJAW	Iwo Jima Airport
RJBB	Kansai International Airport
RJBD	Nanki Shirahama Airport
RJBE	Kobe Airport
RJBH	Hiroshimanishi Airport
RJBT	Tajima Airport
RJCB	Tokachi-Obihiro Airport
RJCC	New Chitose Airport
RJCH	Hakodate Airport
RJCJ	Chitose Air Base
RJCK	Kushiro Airport
RJCM	Memanbetsu Airport
RJCN	Nakashibetsu Airport
RJCO	Okadama Airport
RJCS	Kenebetsu JASDF Airfield
RJCT	Tokachi Airport
RJCW	Wakkanai Airport
RJDB	Iki Airport
RJDC	Yamaguchi Ube Airport
RJDT	Tsushima Airport
RJEB	Monbetsu Airport
RJEC	Asahikawa Airport
RJEO	Okushiri Airport
RJER	Rishiri Airport
RJFA	Ashiya Airport
RJFC	Yakushima Airport
RJFE	Fukue Airport
RJFF	Fukuoka Airport
RJFG	New Tanegashima Airport
RJFK	Kagoshima Airport
RJFM	Miyazaki Airport
RJFN	Nyutabaru Airport
RJFO	Oita Airport
RJFR	KitakyÅ«shÅ« Airport
RJFS	Saga Airport
RJFT	Kumamoto Airport
RJFU	Nagasaki Airport
RJFY	Kanoya Airport
RJFZ	Tsuiki Air Field
RJGG	Chubu Centrair International Airport
RJKA	Amami Airport
RJKB	Okierabu Airport
RJKI	Kikai Airport
RJKN	Tokunoshima Airport
RJNA	Nagoya Airport
RJNF	Fukui Airport
RJNG	Gifu Airport
RJNH	Hamamatsu Airport
RJNK	Komatsu Airport
RJNO	Oki Airport
rjns	Mt. Fuji Shizuoka Airport
RJNT	Toyama Airport
RJNW	Noto Airport
RJNY	Shizuhama Airport
RJOA	Hiroshima Airport
RJOB	Okayama Airport
RJOC	Izumo Airport
RJOF	Hofu Airport
RJOH	Miho Yonago Airport
RJOI	Iwakuni Marine Corps Air Station
RJOK	KÅchi RyÅma Airport
RJOM	Matsuyama Airport
RJOO	Osaka International Airport
RJOR	Tottori Airport
RJOS	Tokushima Airport/JMSDF Air Base
RJOT	Takamatsu Airport
RJOW	Iwami Airport
RJOY	Yao Airport
RJOZ	Ozuki Airport
RJSA	Aomori Airport
RJSC	Yamagata Airport
RJSD	Sado Airport
RJSF	Fukushima Airport
RJSH	Hachinohe Airport
RJSI	Hanamaki Airport
RJSK	Akita Airport
RJSM	Misawa Air Base
RJSN	Niigata Airport
RJSR	Odate Noshiro Airport
RJSS	Sendai Airport
RJST	Matsushima Air Base
RJSY	Shonai Airport
RJTA	Atsugi Naval Air Facility
RJTE	Tateyama Airport
RJTF	Chofu Airport
RJTH	Hachijojima Airport
RJTJ	Iruma Air Base
RJTK	Kisarazu Airport
RJTL	Shimofusa Airport
RJTO	Oshima Airport
RJTQ	Miyakejima Airport
RJTT	Tokyo Haneda International Airport
RJTU	Utsunomiya Airport
RJTY	Yokota Air Base
RKJB	Muan International Airport
RKJJ	Gwangju Airport
RKJK	Kunsan Air Base
RKJY	Yeosu Airport
RKNN	Gangneung Airport (K-18)
RKNW	Wonju/Hoengseong Air Base (K-38/K-46)
RKNY	Yangyang International Airport
RKPC	Jeju International Airport
RKPD	Jeongseok Airport
RKPK	Gimhae International Airport
RKPS	Sacheon Air Base/Airport
RKPU	Ulsan Airport
RKSG	A 511 Airport
RKSI	Incheon International Airport
RKSM	Seoul Air Base (K-16)
RKSO	Osan Air Base
RKSS	Gimpo International Airport
RKSW	Suwon Airport
RKTH	Pohang Airport (G-815/K-3)
RKTI	Jungwon Air Base/Chungju Airport
RKTN	Daegu Airport
RKTU	Cheongju International Airport/Cheongju Air Base (K-59/G-513)
RKTY	Yecheon Airbase
RMU	RegiÃ³n de Murcia International Airport
ROAH	Naha Airport
RODN	Kadena Air Base
ROKJ	Kumejima Airport
ROMD	Minami-Daito Airport
ROMY	Miyako Airport
RORE	Ie Jima Airport
RORK	Kitadaito Airport
RORS	Shimojishima Airport
RORT	Tarama Airport
RORY	Yoron Airport
ROTM	Futenma Marine Corps Air Station
ROYN	Yonaguni Airport
RPLB	Subic Bay International Airport
RPLC	Diosdado Macapagal International Airport
RPLI	Laoag International Airport
RPLL	Ninoy Aquino International Airport
RPLP	Legazpi City International Airport
RPLT	Itbayat Airport
RPLU	Lubang Airport
RPMA	Allah Valley Airport
RPMB	Rajah Buayan Air Base
RPMC	Awang Airport
RPMD	Francisco Bangoy International Airport
RPME	Bancasi Airport
RPMF	Bislig Airport
RPMG	Dipolog Airport
RPMH	Camiguin Airport
RPMJ	Jolo Airport
RPMN	Sanga Sanga Airport
RPMO	Labo Airport
RPMP	Pagadian Airport
RPMQ	Mati National Airport
RPMR	General Santos International Airport
RPMS	Surigao Airport
RPMW	Tandag Airport
RPMZ	Zamboanga International Airport
RPUB	Loakan Airport
RPUD	Daet Airport
RPUH	San Jose Airport
RPUM	Mamburao Airport
RPUN	Naga Airport
RPUO	Basco Airport
RPUR	Dr.Juan C. Angara Airport
RPUS	San Fernando Airport
RPUT	Tuguegarao Airport
RPUV	Virac Airport
RPUW	Marinduque Airport
RPUY	Cauayan Airport
RPVA	Daniel Z. Romualdez Airport
RPVB	Bacolod-Silay Airport
RPVC	Calbayog Airport
RPVD	Sibulan Airport
RPVE	Godofredo P. Ramos Airport
RPVF	Catarman National Airport
RPVI	Iloilo International Airport
RPVJ	Moises R. Espinosa Airport
RPVK	Kalibo International Airport
RPVM	Mactan Cebu International Airport
RPVO	Ormoc Airport
RPVP	Puerto Princesa Airport
RPVR	Roxas Airport
RPVS	Evelio Javier Airport
RPVT	Tagbilaran Airport
RPVU	Tugdan Airport
RPVV	Francisco B. Reyes Airport
RU-0001	Levashovo Air Base
RU-0008	Bada Air Base
RU-0010	Balashov Air Base
RU-0014	Borisoglebsk Air Base
RU-0015	Khotilovo Air Base
RU-0016	Lipetsk Air Base
RU-0018	Buturlinovka Air Base
RU-0023	Chindant Air Base
RU-0028	Kaliningrad Chkalovsk Naval Air Base
RU-0035	Grozny North Airport
RU-0036	Irkutsk Northwest Airport
RU-0040	Syktyvkar Southwest
RU-0043	Mius Airport
RU-0050	Yamburg Airport
RU-0059	Alakurtti Naval Air Base
RU-0060	Chernyakhovsk Naval Air Base
RU-0064	Ostrov Naval Air Base
RU-0065	Pribylovo Naval Air Base
RU-0089	Krymsk Air Base
RU-0090	Krasnodar Tsentralny Air Base
RU-0098	Oktyabrskiy Air Base
RU-0125	Bobrovka Air Base
RU-0128	Budyonnovsk Air Base
RU-0132	Chernigovka Air Base
RU-0152	Mozdok Air Base
RU-0189	Kostomuksha Airport
RU-0211	Taganrog Tsentralny Air Base
RU-0217	Sormovo Airfield
RU-0240	Seshcha Air Base
RU-0303	Privolzhskiy Air Base
RU-0304	Kapustin Yar Airfield
RU-0327	Vozdvizhenka Air Base
RU-0372	Rostov-na-Donu Tsentralny Air Base
RU-0380	Akhtubinsk Air Base
RU-0764	Kubinka Air Base
RU-1071	Kamensk-Uralskiy Air Base
RU-1892	Dolinsk-Sokol Air Base
RU-2244	Ukrainka Air Base
RU-2344	Samara Kryazh Air Base
RU-2844	Dzhida Air Base
RU-3095	Shadrinsk Air Base
RU-3686	Vorotynsk Air Base
RU-3709	Bagay-Baranovka Air Base
RU-3880	Kansk Air Base
RU-4339	Tambov Air Base
RU-4421	Danilovo Air Base
RU-4464	Olenya Air Base
RU-4536	Rogachyovo Air Base
RU-4609	Shatalovo Air Base
RU-4827	Cheryomushki Air Base
RU-5105	Chuguyevka Air Base
RU-5276	Kilpyavr Air Base
RU-5376	Smuravyovo Air Base
RU-5672	Ivanovo North Air Base
RU-6558	Lyambir Air Base
RU-6560	Ulan-Ude East Airport
RU-6687	Michurinsk Air Base
RU-7576	Step Air Base
RU-7847	Ukkurey Air Base
RU-7911	Yugorsk Sovetsky Air Base
RU-7978	Uprun Air Base
RU-8363	Voronezh Baltimor Air Base
RU-8499	Sharomy Air Base
RU-8602	Engels Air Base
RU-8709	Dorokhovo Air Base
RU-8964	Beryozovka Air Base
RU-8974	Yaroslavl Levtsovo Air Base
RU-9129	Vorkuta Sovetskiy Air Base
RU-9345	Krechevitsy Air Base
RU-9545	Zherdevka Air Base
RU-9937	Rzhev Air Base
RU-9942	Shaykovka Air Base
SAAC	Comodoro Pierrestegui Airport
SAAG	Gualeguaychu Airport
SAAP	General Urquiza Airport
SAAR	Islas Malvinas Airport
SAAV	Sauce Viejo Airport
SABE	Jorge Newbery Airpark
SACO	Ingeniero Ambrosio Taravella Airport
SADF	San Fernando Airport
SADL	La Plata Airport
SADP	El Palomar Airport
SAEZ	Ministro Pistarini International Airport
SAHS	Rincon De Los Sauces Airport
SAHZ	Zapala Airport
SAME	El Plumerillo Airport
SAMM	Comodoro D.R. SalomÃ³n Airport
SAMR	Suboficial Ay Santiago Germano Airport
SANC	Catamarca Airport
SANE	Vicecomodoro Angel D. La Paz AragonÃ©s Airport
SANL	Capitan V A Almonacid Airport
SANR	Termas de RÃ­o Hondo international Airport
SANT	Teniente Benjamin Matienzo Airport
SANU	Domingo Faustino Sarmiento Airport
SAOC	Area De Material Airport
SAOD	Villa Dolores Airport
SAOR	Villa Reynolds Airport
SAOU	Brigadier Mayor D Cesar Raul Ojeda Airport
SAOV	Presidente NÃ©stor Kirchner Regional Airport
SARC	Corrientes Airport
SARE	Resistencia International Airport
SARF	Formosa Airport
SARI	Cataratas Del IguazÃº International Airport
SARL	Paso De Los Libres Airport
SARM	Monte Caseros Airport
SARP	Libertador Gral D Jose De San Martin Airport
SASA	Martin Miguel De Guemes International Airport
SASJ	Gobernador Horacio Guzman International Airport
SASO	OrÃ¡n Airport
SAST	General Enrique Mosconi Airport
SATG	Goya Airport
SATR	Reconquista Airport
SATU	Curuzu Cuatia Airport
SAVB	El Bolson Airport
SAVC	General E. Mosconi Airport
SAVE	Brigadier Antonio Parodi Airport
SAVH	Las Heras Airport
SAVT	Almirante Marco Andres Zar Airport
SAVV	Gobernador Castello Airport
SAVY	El Tehuelche Airport
SAWC	El Calafate Airport
SAWD	Puerto Deseado Airport
SAWE	Hermes Quijada International Airport
SAWG	Piloto Civil N. FernÃ¡ndez Airport
SAWH	Malvinas Argentinas Airport
SAWJ	Capitan D Daniel Vazquez Airport
SAWP	Perito Moreno Airport
SAWU	Santa Cruz Airport
SAZB	Comandante Espora Airport
SAZG	General Pico Airport
SAZH	Tres Arroyos Airport
SAZL	Santa Teresita Airport
SAZM	Ãstor Piazzola International Airport
SAZN	Presidente Peron Airport
SAZO	Necochea Airport
SAZP	Comodoro Pedro Zanni Airport
SAZR	Santa Rosa Airport
SAZS	San Carlos De Bariloche Airport
SAZT	HÃ©roes De Malvinas Airport
SAZV	Villa Gesell Airport
SAZW	Cutral-Co Airport
SAZY	Aviador C. Campos Airport
SBAA	ConceiÃ§Ã£o do Araguaia Airport
SBAF	Campo DÃ©lio Jardim de Mattos Airport
SBAN	Base AÃ©rea Airport
SBAQ	Araraquara Airport
SBAR	Santa Maria Airport
SBAT	Piloto Osvaldo Marques Dias Airport
SBAU	AraÃ§atuba Airport
SBBE	Val de Cans/JÃºlio Cezar Ribeiro International Airport
SBBG	Comandante Gustavo Kraemer Airport
SBBH	Pampulha - Carlos Drummond de Andrade Airport
SBBI	Bacacheri Airport
SBBQ	Major Brigadeiro Doorgal Borges Airport
SBBR	Presidente Juscelino Kubistschek International Airport
SBBT	Chafei Amsei Airport
SBBU	Bauru Airport
SBBV	Atlas Brasil Cantanhede Airport
SBBW	Barra do GarÃ§as Airport
SBBZ	Umberto Modiano Airport
SBCA	Cascavel Airport
SBCC	Cachimbo Airport
SBCF	Tancredo Neves International Airport
SBCG	Campo Grande Airport
SBCH	Serafin Enoss Bertaso Airport
SBCI	Brig. Lysias Augusto Rodrigues Airport
SBCJ	CarajÃ¡s Airport
SBCM	DiomÃ­cio Freitas Airport
SBCO	Canoas Air Force Base
SBCP	Bartolomeu Lisandro Airport
SBCR	CorumbÃ¡ International Airport
SBCT	Afonso Pena Airport
SBCV	Caravelas Airport
SBCX	Hugo Cantergiani Regional Airport
SBCY	Marechal Rondon Airport
SBCZ	Cruzeiro do Sul Airport
SBDN	Presidente Prudente Airport
SBEG	Eduardo Gomes International Airport
SBEK	Jacareacanga Airport
SBFI	Cataratas International Airport
SBFL	HercÃ­lio Luz International Airport
SBFN	Fernando de Noronha Airport
SBFZ	Pinto Martins International Airport
SBGL	Rio GaleÃ£o â€“ Tom Jobim International Airport
SBGM	GuajarÃ¡-Mirim Airport
SBGO	Santa Genoveva Airport
SBGR	Guarulhos - Governador AndrÃ© Franco Montoro International Airport
SBGW	GuaratinguetÃ¡ Airport
SBHT	Altamira Airport
SBIC	Itacoatiara Airport
SBIH	Itaituba Airport
SBIL	Bahia - Jorge Amado Airport
SBIP	Usiminas Airport
SBIZ	Prefeito Renato Moreira Airport
SBJF	Francisco de Assis Airport
SBJP	Presidente Castro Pinto International Airport
SBJV	Lauro Carneiro de Loyola Airport
SBKG	Presidente JoÃ£o Suassuna Airport
SBKP	Viracopos International Airport
SBLJ	Lages Airport
SBLN	Lins Airport
SBLO	Governador JosÃ© Richa Airport
SBLP	Bom Jesus da Lapa Airport
SBMA	JoÃ£o Correa da Rocha Airport
SBMC	MinaÃ§u Airport
SBMD	Monte Dourado Airport
SBME	MacaÃ© Airport
SBMG	Regional de MaringÃ¡ - SÃ­lvio Nane Junior Airport
SBMK	MÃ¡rio Ribeiro Airport
SBML	Frank Miloye Milenkowichiâ€“MarÃ­lia State Airport
SBMN	Ponta Pelada Airport
SBMO	Zumbi dos Palmares Airport
SBMQ	Alberto Alcolumbre Airport
SBMS	Dix-Sept Rosado Airport
SBMT	Campo de Marte Airport
SBMY	ManicorÃ© Airport
SBNF	Ministro Victor Konder International Airport
SBNM	Santo Ã‚ngelo Airport
SBNT	Augusto Severo Airport
SBOI	Oiapoque Airport
SBPA	Salgado Filho Airport
SBPC	PoÃ§os de Caldas - Embaixador Walther Moreira Salles Airport
SBPF	Lauro Kurtz Airport
SBPJ	Brigadeiro Lysias Rodrigues Airport
SBPK	JoÃ£o SimÃµes Lopes Neto International Airport
SBPL	Senador Nilo Coelho Airport
SBPN	Porto Nacional Airport
SBPP	Ponta PorÃ£ Airport
SBPS	Porto Seguro Airport
SBPV	Governador Jorge Teixeira de Oliveira Airport
SBQV	VitÃ³ria da Conquista Airport
SBRB	PlÃ¡cido de Castro Airport
SBRF	Guararapes - Gilberto Freyre International Airport
SBRJ	Santos Dumont Airport
SBRP	Leite Lopes Airport
SBSC	Santa Cruz Air Force Base
SBSG	Governador AluÃ­zio Alves International Airport
SBSJ	Professor Urbano Ernesto Stumpf Airport
SBSL	Marechal Cunha Machado International Airport
SBSM	Santa Maria Airport
SBSN	Maestro Wilson Fonseca Airport
SBSP	Congonhas Airport
SBSR	Prof. Eribelto Manoel Reino State Airport
SBST	Base AÃ©rea de Santos Airport
SBSV	Deputado Luiz Eduardo MagalhÃ£es International Airport
SBTA	Base de AviaÃ§Ã£o de TaubatÃ© Airport
SBTB	Trombetas Airport
SBTE	Senador PetrÃ´nio Portela Airport
SBTF	TefÃ© Airport
SBTK	TarauacÃ¡ Airport
SBTL	TelÃªmaco Borba Airport
SBTS	TiriÃ³s Airport
SBTT	Tabatinga Airport
SBTU	TucuruÃ­ Airport
SBUA	SÃ£o Gabriel da Cachoeira Airport
SBUF	Paulo Afonso Airport
SBUG	Rubem Berta Airport
SBUL	Ten. Cel. Aviador CÃ©sar Bombonato Airport
SBUR	MÃ¡rio de Almeida Franco Airport
SBVG	Major Brigadeiro Trompowsky Airport
SBVH	Brigadeiro CamarÃ£o Airport
SBVT	Eurico de Aguiar Salles Airport
SBYS	Campo Fontenelle Airport
SBZM	Presidente Itamar Franco Airport
SCAR	Chacalluta Airport
SCAT	Desierto de Atacama Airport
SCBA	Balmaceda Airport
SCBE	Barriles Airport
SCCC	Chile Chico Airport
SCCF	El Loa Airport
SCCH	Gral. Bernardo OÂ´Higgins Airport
SCCI	Pdte. Carlos IbaÃ±ez del Campo Airport
SCCY	Teniente Vidal Airport
SCDA	Diego Aracena Airport
SCEL	Comodoro Arturo Merino BenÃ­tez International Airport
SCES	Ricardo GarcÃ­a Posada Airport
SCFA	AndrÃ©s Sabella GÃ¡lvez International Airport
SCFM	Capitan Fuentes Martinez Airport Airport
SCGZ	Guardiamarina ZaÃ±artu Airport
SCHR	Cochrane Airport
SCIE	Carriel Sur Airport
SCIP	Mataveri Airport
SCJO	CaÃ±al Bajo Carlos - Hott Siebert Airport
SCLL	Vallenar Airport
SCNT	Tte. Julio Gallardo Airport
SCQP	La AraucanÃ­a Airport
SCRA	ChaÃ±aral Airport
SCRG	De La Independencia Airport
SCSE	La Florida Airport
SCTC	Maquehue Airport
SCTE	El Tepual Airport
SCTL	Panguilemo Airport
SCTN	ChaitÃ©n Airport
SCTO	Victoria Airport
SCTT	Las Breas Airport
SCVD	Pichoy Airport
SCVM	ViÃ±a del mar Airport
SD-0001	Wadi Seidna Air Base
SDZY	Zona da Mata Regional Airport
SEAM	ChachoÃ¡n Airport
SECO	Francisco De Orellana Airport
SECU	Mariscal Lamar Airport
SEGU	JosÃ© JoaquÃ­n de Olmedo International Airport
SELT	Cotopaxi International Airport
SEMA	Jose Maria Velasco Ibarra Airport
SEMC	Coronel E Carvajal Airport
SEMH	General Manuel Serrano Airport
SEMT	Eloy Alfaro International Airport
SEPV	Reales Tamarindos Airport
SEQM	Mariscal Sucre International Airport
SERO	Santa Rosa International Airport
SESA	General Ulpiano Paez Airport
SETR	Tarapoa Airport
SETU	Teniente Coronel Luis a Mantilla Airport
SFAL	Port Stanley Airport
SGAS	Silvio Pettirossi International Airport
SGAY	Juan De Ayolas Airport
SGES	Guarani International Airport
SGME	Dr. Luis Maria ArgaÃ±a International Airport
SGPI	Carlos Miguel Gimenez Airport
SJTC	Bauru - Arealva Airport
SKAP	Gomez Nino Apiay Air Base
SKAR	El Eden Airport
SKAS	Tres De Mayo Airport
SKBC	Las Flores Airport
SKBG	Palonegro Airport
SKBO	El Dorado International Airport
SKBQ	Ernesto Cortissoz International Airport
SKBS	JosÃ© Celestino Mutis Airport
SKBU	Gerardo Tobar LÃ³pez Airport
SKCC	Camilo Daza International Airport
SKCG	Rafael NuÃ±ez International Airport
SKCL	Alfonso Bonilla Aragon International Airport
SKCO	La Florida Airport
SKCU	Juan H White Airport
SKCV	CoveÃ±as Airport
SKCZ	Las Brujas Airport
SKEB	El Bagre Airport
SKEJ	YariguÃ­es Airport
SKFL	Gustavo Artunduaga Paredes Airport
SKGI	Santiago Vila Airport
SKGO	Santa Ana Airport
SKGP	Juan Casiano Airport
SKIB	Perales Airport
SKIP	San Luis Airport
SKLC	Antonio Roldan Betancourt Airport
SKLM	Jorge Isaac Airport
SKLT	Alfredo VÃ¡squez Cobo International Airport
SKMD	Enrique Olaya Herrera Airport
SKMG	Baracoa Airport
SKMR	Los Garzones Airport
SKMU	Fabio Alberto Leon Bentley Airport
SKMZ	La Nubia Airport
SKNV	Benito Salas Airport
SKOC	Aguas Claras Airport
SKPC	German Olano Airport
SKPD	Obando Airport
SKPE	MatecaÃ±a International Airport
SKPI	Pitalito Airport
SKPP	Guillermo LeÃ³n Valencia Airport
SKPQ	German Olano Air Base
SKPS	Antonio Narino Airport
SKPV	El Embrujo Airport
SKPZ	Paz De Ariporo Airport
SKQU	Mariquita Airport
SKRG	Jose Maria CÃ³rdova International Airport
SKRH	Almirante Padilla Airport
SKSJ	Jorge E. Gonzalez Torres Airport
SKSM	SimÃ³n BolÃ­var International Airport
SKSP	Gustavo Rojas Pinilla International Airport
SKSV	Eduardo Falla Solano Airport
SKTJ	Tunja Airport
SKTM	Gustavo Vargas Airport
SKTQ	Tres Esquinas Air Base
SKUA	MarandÃºa Air Base
SKUC	Santiago Perez Airport
SKUI	El CaraÃ±o Airport
SKUL	Heriberto GÃ­l MartÃ­nez Airport
SKVP	Alfonso LÃ³pez Pumarejo Airport
SKVV	Vanguardia Airport
SKYP	El Yopal Airport
SLBJ	Bermejo Airport
SLCB	Jorge Wilsterman International Airport
SLCO	CapitÃ¡n AnÃ­bal Arab Airport
SLET	El Trompillo Airport
SLLP	El Alto International Airport
SLOR	Juan Mendoza Airport
SLPO	Capitan Nicolas Rojas Airport
SLPS	CapitÃ¡n Av. Salvador Ogaya G. airport
SLSA	Santa Ana Del Yacuma Airport
SLSU	Juana Azurduy De Padilla Airport
SLTJ	Capitan Oriel Lea Plaza Airport
SLTR	Teniente Av. Jorge Henrich Arauz Airport
SLVM	Teniente Coronel Rafael PabÃ³n Airport
SLVR	Viru Viru International Airport
SLYA	Yacuiba Airport
SMJP	Johan Adolf Pengel International Airport
SO-0001	K50 International Airport
SOCA	Cayenne-Rochambeau Airport
SOOG	Saint-Georges-de-l'Oyapock Airport
SPAY	Teniente General Gerardo PÃ©rez Pinedo Airport
SPBC	Caballococha Airport
SPBR	Iberia Airport
SPCL	Cap FAP David Abenzur Rengifo International Airport
SPEO	Teniente FAP Jaime A De Montreuil Morales Airport
SPHI	Capitan FAP Jose A Quinones Gonzales International Airport
SPHO	Coronel FAP Alfredo Mendivil Duarte Airport
SPHZ	Comandante FAP German Arias Graziani Airport
SPIM	Jorge ChÃ¡vez International Airport
SPJA	Juan Simons Vela Airport
SPJE	Shumba Airport
SPJI	Juanjui Airport
SPJJ	Francisco Carle Airport
SPJL	Inca Manco Capac International Airport
SPJR	Mayor General FAP Armando Revoredo Iglesias Airport
SPLO	Ilo Airport
SPME	Capitan FAP Pedro Canga Rodriguez Airport
SPMS	Moises Benzaquen Rengifo Airport
SPNC	Alferez Fap David Figueroa Fernandini Airport
SPPY	Chachapoyas Airport
SPQT	Coronel FAP Francisco Secada Vignetta International Airport
SPQU	RodrÃ­guez BallÃ³n International Airport
SPRU	Capitan FAP Carlos Martinez De Pinillos International Airport
SPSO	CapitÃ¡n FAP RenÃ¡n ElÃ­as Olivera International Airport
SPST	Cadete FAP Guillermo Del Castillo Paredes Airport
SPTN	Coronel FAP Carlos Ciriani Santa Rosa International Airport
SPTU	Padre Aldamiz International Airport
SPUR	CapitÃ¡n FAP Guillermo Concha Iberico International Airport
SPYL	Capitan Montes Airport
SPZA	Maria Reiche Neuman Airport
SPZO	Alejandro Velasco Astete International Airport
SQD	Shangrao Sanqingshan Airport
SQJ	Shaxian Airport
SSZW	Ponta Grossa Airport - Comandante Antonio Amilton Beraldo
SUAA	Angel S Adami Airport
SUDU	Santa Bernardina International Airport
SULS	Capitan Corbeta CA Curbelo International Airport
SUMU	Carrasco International /General C L Berisso Airport
SUSO	Nueva Hesperides International Airport
SVAC	Oswaldo Guevara Mujica Airport
SVAN	Anaco Airport
SVBC	General JosÃ© Antonio Anzoategui International Airport
SVBI	Barinas Airport
SVBL	El Libertador Airbase
SVBM	Barquisimeto International Airport
SVBS	Escuela Mariscal Sucre Airport
SVCB	Aeropuerto "General Tomas de Heres". Ciudad Bolivar
SVCD	Caicara del Orinoco Airport
SVCL	Calabozo Airport
SVCN	Canaima Airport
SVCO	Carora Airport
SVCP	General Francisco BermÃºdez Airport
SVCR	JosÃ© Leonardo Chirinos Airport
SVCS	Oscar Machado Zuluaga Airport
SVCU	CumanÃ¡ (Antonio JosÃ© de Sucre) Airport
SVED	El Dorado Airport
SVEZ	Elorza Airport
SVFM	Francisco de Miranda Airport
SVGD	Guasdalito Airport
SVGI	Guiria Airport
SVGU	Guanare Airport
SVJC	Josefa Camejo International Airport
SVJM	San Juan de Los Morros Airport
SVLF	La Fria Airport
SVMC	La Chinita International Airport
SVMD	Alberto Carnevalli Airport
SVMG	Del Caribe Santiago MariÃ±o International Airport
SVMI	SimÃ³n BolÃ­var International Airport
SVMP	Metropolitano Airport
SVMT	MaturÃ­n Airport
SVPA	Cacique Aramare Airport
SVPC	General Bartolome Salom International Airport
SVPM	Paramillo Airport
SVPR	General Manuel Carlos Piar International Airport
SVPT	Palmarito Airport
SVSA	San Antonio Del Tachira Airport
SVSE	Santa Elena de Uairen Airport
SVSO	Mayor Buenaventura Vivas International Airport
SVSP	Sub Teniente Nestor Arias Airport
SVSR	San Fernando De Apure Airport
SVST	San TomÃ© Airport
SVSZ	Santa BÃ¡rbara del Zulia Airport
SVTC	Tucupita Airport
SVTM	Tumeremo Airport
SVVA	Arturo Michelena International Airport
SVVG	Juan Pablo PÃ©rez Alfonso Airport
SVVL	Dr. Antonio NicolÃ¡s BriceÃ±o Airport
SVVP	Valle de La Pascua Airport
SWGN	AraguaÃ­na Airport
SYCJ	Cheddi Jagan International Airport
SYGO	Eugene F. Correira International Airport
SYLT	Lethem Airport
TAPA	V.C. Bird International Airport
TBPB	Sir Grantley Adams International Airport
TDCF	Canefield Airport
TDPD	Douglas-Charles Airport
TFFF	Martinique AimÃ© CÃ©saire International Airport
TFFG	L'EspÃ©rance Airport
TFFJ	Gustaf III Airport
TFFM	Les Bases Airport
TFFR	Pointe-Ã -Pitre Le Raizet
TGPY	Point Salines International Airport
TIST	Cyril E. King Airport
TISX	Henry E Rohlsen Airport
TJ-UT45	Gissar Air Base
TJ-UT46	Farkhor Air Base
TJAB	Antonio Nery Juarbe Pol Airport
TJBQ	Rafael Hernandez Airport
TJFA	Diego Jimenez Torres Airport
TJIG	Fernando Luis Ribas Dominicci Airport
TJMZ	Eugenio Maria De Hostos Airport
TJPS	Mercedita Airport
TJSJ	Luis Munoz Marin International Airport
TKPK	Robert L. Bradshaw International Airport
TKPN	Vance W. Amory International Airport
TLPC	George F. L. Charles Airport
TLPL	Hewanorra International Airport
TM-UT52	Mary North Airport
TN-0002	Enfidha - Hammamet International Airport
TNCA	Queen Beatrix International Airport
TNCB	Flamingo International Airport
TNCC	Hato International Airport
TNCE	F. D. Roosevelt Airport
TNCM	Princess Juliana International Airport
TNW	Jumandy Airport
TQPF	Clayton J Lloyd International Airport
TR-0004	Temelli Air Base
TR-0021	Ã‡ukurhisar Airport
TR-0026	IÄŸdÄ±r Airport
TR-0028	KeÅŸan Airport
TR-0043	Istanbul Airport
TR-0044	Ã‡ukurova Airport
TRPG	John A. Osborne Airport
TTCP	Tobago-Crown Point Airport
TTPP	Piarco International Airport
TUPJ	Terrance B. Lettsome International Airport
TVSA	Argyle International Airport
TVSB	J F Mitchell Airport
TVSC	Canouan Airport
TVSM	Mustique Airport
TVSU	Union Island International Airport
TW-0004	Zuoying Naval Airfield
TXKF	L.F. Wade International International Airport
UA-0005	Nizhyn Air Base
UA-0010	Oktyabrskoe Air Base
UA-0012	Kirovskoe Air Base
UA-0020	Melitopol Air Base
UA-0022	Kacha Air Base
UA-0025	Bila Tserkva Airfield
UA-0028	Zhovtneve Air Base
UA-0029	Bolshoy Tokmak Air Base
UA30	Batken Airport
UAAA	Almaty Airport
UAAH	Balkhash Airport
UACC	Astana International Airport
UACK	Kokshetau Airport
UACP	Petropavlosk South Airport
UADD	Taraz Airport
UAFL	Issyk-Kul International Airport
UAFM	Manas International Airport
UAFO	Osh Airport
UAFW	Kant Air Base
UAII	Shymkent Airport
UAKD	Zhezkazgan Airport
UAKK	Sary-Arka Airport
UAON	Yubileyniy Airfield
UARR	Uralsk Airport
UASA	Ayaguz Airport
UASB	Ekibastuz Airport
UASK	Ust-Kamennogorsk Airport
UASP	Pavlodar Airport
UASS	Semipalatinsk Airport
UATE	Aktau Airport
UATG	Atyrau Airport
UATR	Chelkar Airport
UATT	Aktobe Airport
UAUU	Kostanay West Airport
UB12	Nasosnaya Air Base
UB13	Stepanakert Air Base
UB14	Kyurdamir Air Base
UB18	Baku Kala Air Base
UBBB	Heydar Aliyev International Airport
UBBG	Ganja Airport
UBBN	Nakhchivan Airport
UBBQ	Gabala International Airport
UDSG	Gyumri Shirak Airport
UDYE	Erebuni Airport
UDYZ	Zvartnots International Airport
UEEE	Yakutsk Airport
UELL	Chulman Airport
UEMA	Moma Airport
UEMM	Magan Airport
UEMO	Olyokminsk Airport
UEMT	Ust-Nera Airport
UENK	Kyzyl-Syr Airport
UENW	Vilyuisk Airport
UERA	Aykhal Airport
UERL	Lensk Airport
UERP	Polyarny Airport
UERR	Mirny Airport
UERS	Saskylakh Airport
UESG	Belaya Gora Airport
UESK	Srednekolymsk Airport
UESO	Chokurdakh Airport
UESS	Cherskiy Airport
UEST	Tiksi Airport
UESU	Zyryanka Airport
UG0U	Gudauta Air Base
UG11	Dollyar Air Base
UG22	Tbilisi Marneuli Air Base
UG24	Tbilisi Soganlug Air Base
UG27	Vaziani Air Base
UG28	Bolshiye Shiraki Air Base
UGEJ	Dzhermuk Airport
UGKO	Kopitnari Airport
UGSB	Batumi International Airport
UGSS	Sukhumi Dranda Airport
UGTB	Tbilisi International Airport
UHB1	Birofeld Air Base
UHBB	Ignatyevo Airport
UHHH	Khabarovsk-Novy Airport
UHK1	Blagodatnoye Air Base
UHKD	Dzemgi Airport
UHKG	Kamenny Ruchey Naval Air Base
UHKK	Komsomolsk-on-Amur Airport
UHKM	Maygatka Airport.
UHMA	Ugolny Airport
UHMD	Provideniya Bay Airport
UHMF	Omsukchan Airport
UHMG	Chaybukha Airport
UHMK	Keperveem Airport
UHMM	Sokol Airport
UHMP	Pevek Airport
UHMS	Seymchan Airport
UHMT	Magadan-13 Airport
UHMW	Severo-Evensk Airport
UHNN	Nikolayevsk-na-Amure Airport
UHOO	Okhotsk Airport
UHPL	Palana Airport
UHPP	Yelizovo Airport
UHSS	Yuzhno-Sakhalinsk Airport
UHWW	Vladivostok International Airport
UIAA	Chita-Kadala Airport
UIAE	Krasnokamensk Airport
UIBB	Bratsk Airport
UIBV	Zheleznogorsk Airport
UIII	Irkutsk Airport
UITT	Ust-Kut Airport
UIUB	Bagdarin Airport
UIUU	Ulan-Ude Airport (Mukhino)
UKBB	Boryspil International Airport
UKCM	Mariupol International Airport
UKCW	Luhansk International Airport
UKDD	Dnipropetrovsk International Airport
UKDE	Zaporizhzhia International Airport
UKDR	Kryvyi Rih International Airport
UKFB	Belbek Airport
UKFF	Simferopol International Airport
UKFG	Gvardeyskoe Air Base
UKFI	Saki Air Base
UKFY	Dzhankoy Airport
UKHH	Kharkiv International Airport
UKKE	Cherkasy International Airport
UKKK	Kiev Zhuliany International Airport
UKKM	Gostomel Airport
UKKO	Ozerne Air Base
UKLH	Khmelnytskyi Airport
UKLI	Ivano-Frankivsk International Airport
UKLL	Lviv International Airport
UKLN	Chernivtsi International Airport
UKLR	Rivne International Airport
UKLU	Uzhhorod International Airport
UKON	Mykolaiv International Airport
UKOO	Odessa International Airport
ULAA	Talagi Airport
ULAK	Severomorsk-1 Naval Air Base
ULAM	Naryan Mar Airport
ULBC	Cherepovets Airport
ULDD	Amderma Airport
ULH	Majeed Bin Abdulaziz Airport
ULKK	Kotlas Airport
ULLI	Pulkovo Airport
ULLP	Pushkin Airport
ULLS	Siversky Air Base
ULMM	Murmansk Airport
ULNR	Staraya Russa Air Base
ULOL	Velikiye Luki Airport
ULOO	Pskov Airport
ULPB	Petrozavodsk Airport
ULPP	Peski Airport
ULPW	Sortavala Airport
ULWW	Vologda Airport
UMBB	Brest Airport
UMGG	Gomel Airport
UMII	Vitebsk Vostochny Airport
UMKK	Khrabrovo Airport
UMMA	Baranavichi Air Base
UMMG	Hrodna Airport
UMMS	Minsk National Airport
UMNB	Babruisk Air Base
UMOO	Mogilev Airport
UNAA	Abakan Airport
UNBB	Barnaul Airport
UNBG	Gorno-Altaysk Airport
UNCC	Novosibirsk North Airport
UNEE	Kemerovo Airport
UNIB	Baykit Airport
UNII	Yeniseysk Airport
UNIP	Podkamennaya Tunguska Airport
UNIS	Severo-Eniseysk Airport
UNIW	Vanavara Airport
UNKL	Yemelyanovo Airport
UNKM	Cheremshanka Airport
UNKO	Sharypovo Airport
UNKS	Achinsk Airport
UNKY	Kyzyl Airport
UNNE	Yeltsovka Airport
UNNT	Tolmachevo Airport
UNOO	Omsk Central Airport
UNOS	Omsk Severny Airport
UNSS	Strezhevoy Airport
UNTT	Bogashevo Airport
UNWW	Spichenkovo Airport
UODD	Dikson Airport
UODN	Nagurskoye
UOHH	Khatanga Airport
UOIG	Svetlogorsk Airport
UOII	Igarka Airport
UOOO	Norilsk-Alykel Airport
UOOW	Valek Airport
URKA	Anapa Vityazevo Airport
URKE	Yeysk Airport
URKG	Gelendzhik Airport
URKH	Khanskaya Air Base
URKK	Krasnodar Pashkovsky International Airport
URMG	Khankala Air Base
URML	Uytash Airport
URMM	Mineralnyye Vody Airport
URMN	Nalchik Airport
URMO	Beslan Airport
URMS	Magas Airport
URMT	Stavropol Shpakovskoye Airport
UROD	Dudinka Airport
URRP	Platov International Airport
URRT	Taganrog Yuzhny Airport
URSS	Sochi International Airport
URWA	Astrakhan Airport
URWI	Elista Airport
URWW	Volgograd International Airport
US-0086	Jim's Private Airport
US-0254	Yuma Auxiliary AAF #2
US-0303	atl
US-0571	Williston Basin International Airport (U.C.)
US-0742	34S Airport
USCC	Chelyabinsk Balandino Airport
USCM	Magnitogorsk International Airport
USDA	Sabetta International Airport
USDD	Salekhard Airport
USHB	Berezovo Airport
USHH	Khanty Mansiysk Airport
USHN	Nyagan Airport
USHS	Sovetskiy Airport
USHU	Uray Airport
USHY	Beloyarskiy Airport
USII	Izhevsk Airport
USKK	Pobedilovo Airport
USMM	Nadym Airport
USMU	Novy Urengoy Airport
USNN	Nizhnevartovsk Airport
USPP	Bolshoye Savino Airport
USRK	Kogalym International Airport
USRN	Nefteyugansk Airport
USRO	Noyabrsk Airport
USRR	Surgut Airport
USSK	Uktus Airport
USSS	Koltsovo Airport
USTR	Roshchino International Airport
USUU	Kurgan Airport
UTAA	Ashgabat International Airport
UTAK	Turkmenbashi Airport
UTAM	Mary Airport
UTAT	DaÅŸoguz Airport
UTAV	Turkmenabat Airport
UTDD	Dushanbe Airport
UTDK	Kulob Airport
UTDL	Khudzhand Airport
UTDT	Qurghonteppa International Airport
UTNU	Urgench Airport
UTSB	Bukhara Airport
UTSS	Samarkand Airport
UTST	Termez Airport
UTTP	Tashkent East Airport
UTTT	Tashkent International Airport
UUBA	Kostroma Sokerkino Airport
UUBC	Grabtsevo Airport
UUBD	Dyagilevo Air Base
UUBI	Ivanovo South Airport
UUBK	Staroselye Airport
UUBL	Semyazino Airport
UUBM	Myachkovo Airport
UUBP	Bryansk Airport
UUBW	Zhukovsky International Airport
UUDD	Domodedovo International Airport
UUEE	Sheremetyevo International Airport
UUEM	Migalovo Air Base
UUMO	Ostafyevo International Airport
UUMT	Tretyakovo Airport
UUMU	Chkalovskiy Air Base
UUOB	Belgorod International Airport
UUOK	Kursk East Airport
UUOL	Lipetsk Airport
UUOO	Voronezh International Airport
UUOR	Oryol Yuzhny Airport
UUOT	Donskoye Airport
UUWE	Yermolino Air Base
UUWW	Vnukovo International Airport
UUYH	Ukhta Airport
UUYI	Inta Airport
UUYK	Vuktyl Airport
UUYP	Pechora Airport
UUYS	Usinsk Airport
UUYV	Izhma Airport
UUYW	Vorkuta Airport
UUYX	Ust-Tsylma Airport
UUYY	Syktyvkar Airport
UWGG	Nizhny Novgorod Strigino International Airport
UWKB	Bugulma Airport
UWKD	Kazan International Airport
UWKE	Begishevo Airport
UWKG	Borisoglebskoye Airport
UWKJ	Yoshkar-Ola Airport
UWKS	Cheboksary Airport
UWKV	Zhigansk Airport
UWLL	Ulyanovsk Baratayevka Airport
UWLW	Ulyanovsk East Airport
UWOO	Orenburg Central Airport
UWOR	Orsk Airport
UWPP	Penza Airport
UWPS	Saransk Airport
UWSB	Balakovo Airport
UWSS	Saratov Central Airport
UWUM	Maksimovka Airport
UWUU	Ufa International Airport
UWWB	Buguruslan Severny Airport
UWWG	Bezymyanka Airfield
UWWW	Kurumoch International Airport
VA1G	Rewa Airport, Chorhata, REWA
VAAH	Sardar Vallabhbhai Patel International Airport
VAAK	Akola Airport
VAAU	Aurangabad Airport
VABB	Chhatrapati Shivaji International Airport
VABI	Bilaspur Airport
VABJ	Bhuj Airport
VABM	Belgaum Airport
VABO	Vadodara Airport
VABP	Raja Bhoj International Airport
VABV	Bhavnagar Airport
VADN	Daman Airport
VAGO	Dabolim Airport
VAHB	Hubli Airport
VAID	Devi Ahilyabai Holkar Airport
VAJB	Jabalpur Airport
VAJM	Jamnagar Airport
VAKE	Kandla Airport
VAKJ	Khajuraho Airport
VAKP	Kolhapur Airport
VAKS	Keshod Airport
VAND	Nanded Airport
VANP	Dr. Babasaheb Ambedkar International Airport
VAOZ	Nashik Airport
VAPO	Pune Airport
VAPR	Porbandar Airport
VARG	Ratnagiri Airport
VARK	Rajkot Airport
VASD	Shirdi Airport
VASL	Solapur Airport
VASU	Surat Airport
VAUD	Maharana Pratap Airport
VCBI	Bandaranaike International Colombo Airport
VCCA	Anuradhapura Air Force Base
VCCB	Batticaloa Airport
VCCC	Colombo Ratmalana Airport
VCCG	Ampara Airport
VCCH	Hingurakgoda Air Force Base
VCCJ	Kankesanturai Airport
VCCK	Koggala Airport
VCCT	China Bay Airport
VCRI	Mattala Rajapaksa International Airport
VDBG	Battambang Airport
VDKH	Kampong Chhnang Airport
VDPP	Phnom Penh International Airport
VDRK	Ratanakiri Airport
VDSR	Siem Reap International Airport
VDST	Stung Treng Airport
VE44	Hashimara Air Force Station
VEAN	Along Airport
VEAT	Agartala Airport
VEBD	Bagdogra Airport
VEBI	Shillong Airport
VEBS	Biju Patnaik Airport
VECC	Netaji Subhash Chandra Bose International Airport
VEDB	Dhanbad Airport
VEDG	Kazi Nazrul Islam Airport
VEGK	Gorakhpur Airport
VEGT	Lokpriya Gopinath Bordoloi International Airport
VEGY	Gaya Airport
VEIM	Imphal Airport
VEJS	Sonari Airport
VEJT	Jorhat Airport
VEKR	Kailashahar Airport
VEKU	Silchar Airport
VELP	Lengpui Airport
VELR	North Lakhimpur Airport
VEMN	Dibrugarh Airport
VEMR	Dimapur Airport
VEMZ	Muzaffarpur Airport
VEPH	Panagarh Air Force Station
VEPT	Lok Nayak Jayaprakash Airport
VERC	Birsa Munda Airport
VERK	Rourkela Airport
VETZ	Tezpur Airport
VEZO	Ziro Airport
VGBR	Barisal Airport
VGCB	Cox's Bazar Airport
VGEG	Shah Amanat International Airport
VGIS	Ishurdi Airport
VGJR	Jessore Airport
VGRJ	Shah Mokhdum Airport
VGSD	Saidpur Airport
VGSY	Osmany International Airport
VGZR	Hazrat Shahjalal International Airport
VHHH	Hong Kong International Airport
VHSK	Shek Kong Air Base
VIAG	Agra Airport
VIAL	Allahabad Airport
VIAM	Ambala Air Force Station
VIAR	Sri Guru Ram Dass Jee International Airport
VIBK	Nal Airport
VIBN	Lal Bahadur Shastri Airport
VIBR	Kullu Manali Airport
VIBT	Bhatinda Air Force Station
VIBY	Bareilly Air Force Station
VICG	Chandigarh Airport
VICX	Kanpur Airport
VIDD	Safdarjung Airport
VIDN	Dehradun Airport
VIDP	Indira Gandhi International Airport
VIGG	Kangra Airport
VIGR	Gwalior Airport
VIHR	Hissar Airport
VIJO	Jodhpur Airport
VIJP	Jaipur International Airport
VIJR	Jaisalmer Airport
VIJU	Jammu Airport
VIKG	Kishangarh Airport
VIKO	Kota Airport
VILD	Ludhiana Airport
VILH	Leh Kushok Bakula Rimpochee Airport
VILK	Chaudhary Charan Singh International Airport
VIPK	Pathankot Airport
VIPT	Pantnagar Airport
VISA	Sirsa Air Force Station
VISR	Sheikh ul Alam Airport
VIUX	Udhampur Air Force Station
VLLB	Luang Phabang International Airport
VLPS	Pakse International Airport
VLSK	Savannakhet Airport
VLSN	Sam Neua Airport
VLVT	Wattay International Airport
VMMC	Macau International Airport
VN-0001	Dong Hoi Airport
VN-KON	Kontum Airport
VNBW	Gautam Buddha Airport
VNJP	Janakpur Airport
VNKT	Tribhuvan International Airport
VNNG	Nepalgunj Airport
VNPK	Pokhara Airport
VNTJ	Taplejung Airport
VNVT	Biratnagar Airport
VO55	Murod Kond Airport
VOAT	Agatti Airport
VOBG	HAL Airport
VOBI	Bellary Airport
VOBL	Kempegowda International Airport
VOBR	Bidar Air Force Station
VOBZ	Vijayawada Airport
VOCB	Coimbatore International Airport
VOCI	Cochin International Airport
VOCL	Calicut International Airport
VOCP	Kadapa Airport
VOCX	Car Nicobar Air Force Station
VODG	Dundigul Air Force Academy
VOHS	Rajiv Gandhi International Airport
VOHY	Begumpet Airport
VOKN	Kannur International Airport
VOMD	Madurai Airport
VOML	Mangalore International Airport
VOMM	Chennai International Airport
VOPB	Vir Savarkar International Airport
VOPC	Pondicherry Airport
VOPN	Sri Sathya Sai Airport
VORY	Rajahmundry Airport
VOSM	Salem Airport
VOTR	Tiruchirapally Civil Airport Airport
VOTV	Trivandrum International Airport
VQGP	Gelephu Airport
VQPR	Paro Airport
VRMG	Gan International Airport
VRMH	Hanimaadhoo Airport
VRMK	Kadhdhoo Airport
VRMM	MalÃ© International Airport
VRMT	Kaadedhdhoo Airport
VRMV	Villa Airport
VTBD	Don Mueang International Airport
VTBK	Kamphaeng Saen Airport
VTBL	Khok Kathiam Airport
VTBO	Trat Airport
VTBS	Suvarnabhumi Airport
VTBU	U-Tapao International Airport
VTCC	Chiang Mai International Airport
VTCH	Mae Hong Son Airport
VTCL	Lampang Airport
VTCN	Nan Airport
VTCP	Phrae Airport
VTCT	Chiang Rai International Airport
VTPB	Phetchabun Airport
VTPH	Hua Hin Airport
VTPI	Takhli Airport
VTPM	Mae Sot Airport
VTPO	Sukhothai Airport
VTPP	Phitsanulok Airport
VTPT	Tak Airport
VTSB	Surat Thani Airport
VTSC	Narathiwat Airport
VTSE	Chumphon Airport
VTSF	Nakhon Si Thammarat Airport
VTSG	Krabi Airport
VTSH	Songkhla Airport
VTSK	Pattani Airport
VTSM	Samui Airport
VTSN	Cha Eian Airport
VTSP	Phuket International Airport
VTSR	Ranong Airport
VTSS	Hat Yai International Airport
VTST	Trang Airport
VTUD	Udon Thani Airport
VTUI	Sakon Nakhon Airport
VTUJ	Surin Airport
VTUK	Khon Kaen Airport
VTUL	Loei Airport
VTUO	Buri Ram Airport
VTUQ	Nakhon Ratchasima Airport
VTUU	Ubon Ratchathani Airport
VTUV	Roi Et Airport
VTUW	Nakhon Phanom Airport
VVBM	Buon Ma Thuot Airport
VVCI	Cat Bi International Airport
VVCM	CÃ  Mau Airport
VVCR	Cam Ranh Airport
VVCS	Co Ong Airport
VVCT	Can Tho International Airport
VVDB	Dien Bien Phu Airport
VVDL	Lien Khuong Airport
VVDN	Da Nang International Airport
VVGL	Gia Lam Air Base
VVNB	Noi Bai International Airport
VVPB	Phu Bai Airport
VVPC	Phu Cat Airport
VVPK	Pleiku Airport
VVPQ	Phu Quoc International Airport
VVRG	Rach Gia Airport
VVTH	Dong Tac Airport
VVTS	Tan Son Nhat International Airport
VVVH	Vinh Airport
VYDW	Dawei Airport
VYEL	Naypyidaw Airport
VYHH	Heho Airport
VYKG	Kengtung Airport
VYKP	Kyaukpyu Airport
VYKT	Kawthoung Airport
VYLK	Loikaw Airport
VYLS	Lashio Airport
VYMD	Mandalay International Airport
VYME	Myeik Airport
VYMK	Myitkyina Airport
VYML	Meiktila Air Base
VYMO	Momeik Airport
VYMS	Mong Hsat Airport
VYNP	Nampong Air Base
VYNS	Namsang Airport
VYPT	Putao Airport
VYST	Shante Air Base
VYSW	Sittwe Airport
VYTD	Thandwe Airport
VYTL	Tachileik Airport
VYYY	Yangon International Airport
WAAA	Hasanuddin International Airport
WABB	Frans Kaisiepo Airport
WABI	Nabire Airport
WABP	Moses Kilangin Airport
WADD	Ngurah Rai (Bali) International Airport
WADL	Lombok International Airport
WAJJ	Sentani International Airport
WAJW	Wamena Airport
WAKK	Mopah Airport
WALK	Kalimarau Airport
WALR	Juwata Airport
WALS	Temindung Airport
WAMH	Naha Airport
WAML	Mutiara Airport
WAMM	Sam Ratulangi Airport
WAMP	Kasiguncu Airport
WAMR	Pitu Airport
WAMT	Sultan Khairun Babullah Airport
WAMW	Syukuran Aminuddin Amir Airport
WAON	Warukin Airport
WAPL	Dumatumbun Airport
WAPP	Pattimura Airport, Ambon
WARR	Juanda International Airport
WASF	Fakfak Airport
WASK	Kaimana Airport
WASO	Babo Airport
WASR	Rendani Airport
WAXX	Dominique Edward Osok Airport
WBGB	Bintulu Airport
WBGG	Kuching International Airport
WBGJ	Limbang Airport
WBGM	Marudi Airport
WBGR	Miri Airport
WBGS	Sibu Airport
WBGZ	Bario Airport
WBKD	Lahad Datu Airport
WBKK	Kota Kinabalu International Airport
WBKL	Labuan Airport
WBKS	Sandakan Airport
WBKW	Tawau Airport
WBMU	Mulu Airport
WBSB	Brunei International Airport
WIAT	Radin Inten II (Branti) Airport
WIBB	Sultan Syarif Kasim Ii (Simpang Tiga) Airport
WIBD	Pinang Kampai Airport
WICC	Husein Sastranegara International Airport
WIDD	Hang Nadim International Airport
WIHH	Halim Perdanakusuma International Airport
WIHL	Tunggul Wulung Airport
WIII	Soekarno-Hatta International Airport
WIMB	Binaka Airport
WIME	Aek Godang Airport
WIMG	Tabing Airport
WIMK	Soewondo Air Force Base
WIMM	Kualanamu International Airport
WIOG	Nanga Pinoh Airport
WIOK	Ketapang(Rahadi Usman) Airport
WION	Ranai Airport
WIOO	Supadio Airport
WIOP	Pangsuma Airport
WIOS	Sintang(Susilo) Airport
WIPL	Fatmawati Soekarno Airport
WIPP	Sultan Mahmud Badaruddin II Airport
WIPQ	Pendopo Airport
WIPR	Japura Airport
WIPT	Minangkabau International Airport
WITL	Lhok Sukon Airport
WITT	Sultan Iskandar Muda International Airport
WMAP	Kluang Airport
WMBT	Pulau Tioman Airport
WMKA	Sultan Abdul Halim Airport
WMKB	Butterworth Airport
WMKC	Sultan Ismail Petra Airport
WMKD	Kuantan Airport
WMKE	Kerteh Airport
WMKI	Sultan Azlan Shah Airport
WMKJ	Senai International Airport
WMKK	Kuala Lumpur International Airport
WMKL	Langkawi International Airport
WMKM	Malacca Airport
WMKN	Sultan Mahmud Airport
WMKP	Penang International Airport
WMSA	Sultan Abdul Aziz Shah International Airport
WPDB	Suai Airport
WPDL	Presidente Nicolau Lobato International Airport
WPEC	Cakung Airport
WSAC	Changi Air Base (East)
WSAG	Sembawang Air Base
WSAP	Paya Lebar Air Base
WSAT	Tengah Air Base
WSSL	Seletar Airport
WSSS	Singapore Changi Airport
XK-0001	KFOR Base Airfield
XLLL	Soltsy-2 Air Base
XLMV	Severomorsk-3 Naval Air Base
XLWF	Fedotovo Naval Air Base
XRWL	Lebyazhye Air Base
XUBS	Smolensk North Airport
XWPR	Rtishchevo Air Base
YABA	Albany Airport
YAMB	RAAF Base Amberley
YAPH	Alpha Airport
YARA	Ararat Airport
YARM	Armidale Airport
YAYE	Ayers Rock Connellan Airport
YBAR	Barcaldine Airport
YBAS	Alice Springs Airport
YBBN	Brisbane International Airport
YBCG	Gold Coast Airport
YBCK	Blackall Airport
YBCS	Cairns International Airport
YBCV	Charleville Airport
YBDV	Birdsville Airport
YBHI	Broken Hill Airport
YBHM	Hamilton Island Airport
YBIE	Bedourie Airport
YBKE	Bourke Airport
YBLA	Benalla Airport
YBMA	Mount Isa Airport
YBMC	Sunshine Coast Airport
YBMK	Mackay Airport
YBNA	Ballina Byron Gateway Airport
YBNS	Bairnsdale Airport
YBOK	Oakey Airport
YBOU	Boulia Airport
YBPN	Proserpine Whitsunday Coast Airport
YBRK	Rockhampton Airport
YBRM	Broome International Airport
YBRN	Balranald Airport
YBRW	Brewarrina Airport
YBTH	Bathurst Airport
YBTI	Bathurst Island Airport
YBTL	Townsville Airport
YBTR	Blackwater Airport
YBUD	Bundaberg Airport
YBWP	Weipa Airport
YBWW	Toowoomba Wellcamp Airport
YCAR	Carnarvon Airport
YCBA	Cobar Airport
YCBB	Coonabarabran Airport
YCBP	Coober Pedy Airport
YCCA	Chinchilla Airport
YCCY	Cloncurry Airport
YCDU	Ceduna Airport
YCEE	Cleve Airport
YCIN	RAAF Base Curtin
YCKN	Cooktown Airport
YCMT	Clermont Airport
YCMU	Cunnamulla Airport
YCNM	Coonamble Airport
YCOE	Coen Airport
YCOM	Cooma Snowy Mountains Airport
YCOR	Corowa Airport
YCRG	Corryong Airport
YCTM	Cootamundra Airport
YCWR	Cowra Airport
YDBI	Dirranbandi Airport
YDBY	Derby Airport
YDLQ	Deniliquin Airport
YDPO	Devonport Airport
YDYS	Dysart Airport
YECH	Echuca Airport
YELD	Elcho Island Airport
YEML	Emerald Airport
YESP	Esperance Airport
YFBS	Forbes Airport
YFRT	Forrest Airport
YFTZ	Fitzroy Crossing Airport
YGDH	Gunnedah Airport
YGEL	Geraldton Airport
YGFN	Grafton Airport
YGLA	Gladstone Airport
YGLB	Goulburn Airport
YGLI	Glen Innes Airport
YGPT	Garden Point Airport
YGTE	Groote Eylandt Airport
YGTH	Griffith Airport
YHAY	Hay Airport
YHBA	Hervey Bay Airport
YHID	Horn Island Airport
YHLC	Halls Creek Airport
YHML	Hamilton Airport
YHOT	Mount Hotham Airport
YHPN	Hopetoun Airport
YHSM	Horsham Airport
YIVL	Inverell Airport
YKER	Kerang Airport
YKII	King Island Airport
YKMP	Kempsey Airport
YKOW	Kowanyama Airport
YKRY	Kingaroy Airport
YKSC	Kingscote Airport
YLEC	Leigh Creek Airport
YLEO	Leonora Airport
YLHR	Lockhart River Airport
YLIS	Lismore Airport
YLRD	Lightning Ridge Airport
YLRE	Longreach Airport
YLST	Leinster Airport
YLTV	Latrobe Valley Airport
YMAV	Avalon Airport
YMAY	Albury Airport
YMBA	Mareeba Airport
YMDG	Mudgee Airport
YMEK	Meekatharra Airport
YMEN	Melbourne Essendon Airport
YMER	Merimbula Airport
YMES	RAAF Base East Sale
YMGD	Maningrida Airport
YMHB	Hobart International Airport
YMIA	Mildura Airport
YMLT	Launceston Airport
YMMB	Melbourne Moorabbin Airport
YMML	Melbourne International Airport
YMNE	Mount Keith Airport
YMOG	Mount Magnet Airport
YMOR	Moree Airport
YMRB	Moranbah Airport
YMRY	Moruya Airport
YMTG	Mount Gambier Airport
YNAR	Narrandera Airport
YNBR	Narrabri Airport
YNGU	Ngukurr Airport
YNRM	Narromine Airport
YNTN	Normanton Airport
YNWN	Newman Airport
YORG	Orange Airport
YPAD	Adelaide International Airport
YPAG	Port Augusta Airport
YPBO	Paraburdoo Airport
YPCC	Cocos (Keeling) Islands Airport
YPDN	Darwin International Airport
YPEA	RAAF Base Pearce
YPED	RAAF Base Edinburgh
YPGV	Gove Airport
YPIR	Port Pirie Airport
YPJT	Perth Jandakot Airport
YPKA	Karratha Airport
YPKG	Kalgoorlie Boulder Airport
YPKS	Parkes Airport
YPKT	Port Keats Airport
YPKU	Kununurra Airport
YPLC	Port Lincoln Airport
YPLM	Learmonth Airport
YPMQ	Port Macquarie Airport
YPOD	Portland Airport
YPPD	Port Hedland International Airport
YPPH	Perth International Airport
YPTN	Tindal Airport
YPXM	Christmas Island Airport
YQLP	Quilpie Airport
YREN	Renmark Airport
YROM	Roma Airport
YSBK	Sydney Bankstown Airport
YSCB	Canberra International Airport
YSCH	Coffs Harbour Airport
YSCN	Camden Airport
YSDU	Dubbo City Regional Airport
YSHK	Shark Bay Airport
YSHT	Shepparton Airport
YSMI	Smithton Airport
YSNB	Snake Bay Airport
YSNF	Norfolk Island International Airport
YSNW	Nowra Airport
YSRI	RAAF Base Richmond
YSSY	Sydney Kingsford Smith International Airport
YSTW	Tamworth Airport
YSWG	Wagga Wagga City Airport
YSWH	Swan Hill Airport
YSWL	Stawell Airport
YTEF	Telfer Airport
YTEM	Temora Airport
YTGM	Thargomindah Airport
YTIB	Tibooburra Airport
YTMU	Tumut Airport
YTNG	Thangool Airport
YTNK	Tennant Creek Airport
YTRE	Taree Airport
YTY	Yangzhou Taizhou Airport
YWDH	Windorah Airport
YWGT	Wangaratta Airport
YWHA	Whyalla Airport
YWKB	Warracknabeal Airport
YWLG	Walgett Airport
YWLM	Newcastle Airport
YWLU	Wiluna Airport
YWOL	Wollongong Airport
YWRN	Warren Airport
YWSL	West Sale Airport
YWTN	Winton Airport
YWWL	West Wyalong Airport
YWYY	Wynyard Airport
YYA	Sanhe Airport
YYNG	Young Airport
Z19O	Wujah Al Hajar Air Base
ZBAA	Beijing Capital International Airport
ZBAD	Beijing Daxing International Airport
ZBBB	Beijing Xijiao Airport
ZBCD	Chengde Puning Airport
ZBCF	Chifeng Airport
ZBDH	Qinhuangdao Beidaihe Airport
ZBDS	Ordos Ejin Horo Airport
ZBER	Erenhot Saiwusu International Airport
ZBES	Arxan Yi'ershi Airport
ZBHD	Handan Airport
ZBHH	Baita International Airport
ZBHZ	Holingol Huolinhe Airport
ZBLA	Dongshan Airport
ZBLF	Linfen Qiaoli Airport
ZBLL	LÃ¼liang Airport
ZBMZ	Manzhouli Xijiao Airport
ZBNY	Beijing Nanyuan Airport
ZBOW	Baotou Airport
ZBSJ	Shijiazhuang Daguocun International Airport
ZBTJ	Tianjin Binhai International Airport
ZBTL	Tongliao Airport
ZBUC	Ulanqab Jining Airport
ZBXH	Xilinhot Airport
ZBYN	Taiyuan Wusu Airport
ZBYZ	Bayannur Tianjitai Airport
ZBZL	Chengjisihan Airport
ZGCD	Changde Airport
ZGCJ	Zhijiang Airport
ZGGG	Guangzhou Baiyun International Airport
ZGHA	Changsha Huanghua International Airport
ZGHC	Hechi Jinchengjiang Airport
ZGKL	Guilin Liangjiang International Airport
ZGLG	Lingling Airport
ZGNN	Nanning Wuxu Airport
ZGOW	Jieyang Chaoshan International Airport
ZGSD	Zhuhai Jinwan Airport
ZGSY	Shaoyang Wugang Airport
ZGSZ	Shenzhen Bao'an International Airport
ZGZH	Liuzhou Bailian Airport
ZGZJ	Zhanjiang Airport
ZHCC	Zhengzhou Xinzheng International Airport
ZHGH	Guangzhou MR Air Base
ZHHH	Wuhan Tianhe International Airport
ZHSN	Shennongjia Hongping Airport
ZHSY	Shiyan Wudangshan Airport
ZHYC	Yichang Sanxia Airport
ZJHK	Haikou Meilan International Airport
ZJQH	Qionghai Bo'ao Airport
ZJSY	Sanya Phoenix International Airport
ZKPY	Pyongyang Sunan International Airport
ZKSC	Sunchon Air Base
ZKSD	Sondok Airport
ZKWS	Wonsan Kalma International Airport
ZLDH	Dunhuang Airport
ZLGM	Golmud Airport
ZLGY	Guyuan Liupanshan Airport
ZLHX	Huatugou Airport
ZLJN	Jining Qufu Airport
ZLJQ	Jiayuguan Airport
ZLLL	Lanzhou Zhongchuan Airport
ZLLN	Longnan Chengzhou Airport
ZLQY	Qingyang Airport
ZLSN	Xi'an Xiguan Airport
ZLXH	Gannan Xiahe Airport
ZLXN	Xining Caojiabu Airport
ZLXY	Xi'an Xianyang International Airport
ZLZW	Zhongwei Shapotou Airport
ZMAH	Arvaikheer Airport
ZMAT	Altai Airport
ZMBH	Bayankhongor Airport
ZMBN	Bulgan Airport
ZMBU	Baruun Urt Airport
ZMCD	Choibalsan Airport
ZMDZ	Dalanzadgad Airport
ZMKD	Khovd Airport
ZMMN	MÃ¶rÃ¶n Airport
ZMUB	Chinggis Khaan International Airport
ZPCW	Cangyuan Washan Airport
ZPDL	Dali Airport
ZPDQ	Diqing Airport
ZPJH	Xishuangbanna Gasa Airport
ZPJM	Lancang Jingmai Airport
ZPLJ	Lijiang Airport
ZPLX	Mangshi Airport
ZPPP	Kunming Changshui International Airport
ZSAM	Xiamen Gaoqi International Airport
ZSAQ	Anqing Tianzhushan Airport
ZSBB	Bengbu Airport
ZSCN	Nanchang Changbei International Airport
ZSFY	Fuyang Xiguan Airport
ZSFZ	Fuzhou Changle International Airport
ZSHC	Hangzhou Xiaoshan International Airport
ZSJD	Jingdezhen Airport
ZSJN	Yaoqiang Airport
ZSJU	Quzhou Airport
ZSLD	Longyan Guanzhishan Airport
ZSLQ	Huangyan Luqiao Airport
ZSNB	Ningbo Lishe International Airport
ZSNJ	Nanjing Lukou Airport
ZSOF	Hefei Luogang International Airport
ZSPD	Shanghai Pudong International Airport
ZSQD	Liuting Airport
ZSQZ	Quanzhou Jinjiang International Airport
ZSRG	Rugao Air Base
ZSRZ	Rizhao Shanzihe Airport
ZSSS	Shanghai Hongqiao International Airport
ZSSZ	Suzhou Guangfu Airport
ZSTX	Tunxi International Airport
ZSWF	Weifang Airport
ZSWH	Weihai Airport
ZSWU	Wuhu Air Base
ZSWX	Sunan Shuofang International Airport
ZSWY	Nanping Wuyishan Airport
ZSWZ	Wenzhou Longwan International Airport
ZSXZ	Xuzhou Guanyin Airport
ZSYA	Yangzhou Taizhou Airport
ZSYC	Yichun Mingyueshan Airport
ZSYT	Yantai Laishan Airport
ZSYW	Yiwu Airport
ZUAL	Ngari Gunsa Airport
ZUAS	Anshun Huangguoshu Airport
ZUBD	Qamdo Bangda Airport
ZUBJ	Bijie Feixiong Airport
ZUCK	Chongqing Jiangbei International Airport
ZUDC	Daocheng Yading Airport
ZUGU	Guangyuan Airport
ZUGY	Longdongbao Airport
ZUJZ	Jiuzhai Huanglong Airport
ZUKD	Kangding Airport
ZUKJ	Kaili Airport
ZULS	Lhasa Gonggar Airport
ZUMT	Zunyi Maotai Airport
ZUMY	Mianyang Airport
ZUNP	Liping Airport
ZUNZ	Nyingchi Airport
ZUPS	Liupanshui Yuezhao Airport
ZUTC	Tengchong Tuofeng Airport
ZUUU	Chengdu Shuangliu International Airport
ZUXC	Xichang Qingshan Airport
ZUYI	Xingyi Airport
ZUZY	Zunyi Xinzhou Airport
ZWAK	Aksu Airport
ZWAX	Alashankou Bole (Bortala) airport
ZWCM	Qiemo Yudu Airport
ZWFY	Fuyun Koktokay Airport
ZWHM	Hami Airport
ZWKL	Korla Airport
ZWKN	Kanas Airport
ZWNL	Xinyuan Nalati Airport
ZWSC	Yeerqiang Airport
ZWSH	Kashgar Airport
ZWSS	Shanshan Airport
ZWTN	Hotan Airport
ZWTP	Turpan Jiaohe Airport
ZWWW	ÃœrÃ¼mqi Diwopu International Airport
ZYAS	Anshan Air Base
ZYCC	Longjia Airport
ZYCH	Changhai Airport
ZYCY	Chaoyang Airport
ZYDU	Wudalianchi Dedu Airport
ZYFY	Dongji Aiport
ZYHB	Taiping Airport
ZYHE	Heihe Airport
ZYJM	Jiamusi Airport
ZYJS	Jiansanjiang Airport
ZYJX	Jixi Xingkaihu Airport
ZYJZ	Jinzhou Airport
ZYLD	Lindu Airport
ZYLS	Yushu Batang Airport
ZYMD	Mudanjiang Hailang International Airport
ZYMH	Gu-Lian Airport
ZYQQ	Qiqihar Sanjiazi Airport
ZYSQ	Songyuan Chaganhu Airport
ZYTL	Zhoushuizi Airport
ZYTN	Tonghua Sanyuanpu Airport
ZYTX	Taoxian Airport
ZYYJ	Yanji Chaoyangchuan Airport
ZYYK	Yingkou Lanqi Airport
ZYYY	Shenyang Dongta Airport
